丁	一 亅
七	一 乚	丿 乚
万	一 勹	一 刀
丈	一 乂
三	一 二	一 一 一
上	一 丨 一	丶 丨 一
下	一 卜	一 丨 丶
不	一 丿 丨 丶
丐	下 勹	正 丿
丑	㇆ 一 丨 一
且	月 一
丕	不 一
世	廿 丨 一
丘	厂 工	厂 丅 一
丙	一 人 冂
丞	氶 一
丢	丿 去
并	丷 开
丫	丶 丶 丨
中	口 丨
丰	丿 二 丨	三 丨
串	口 口 丨	中 口
丸	丶 九
丹	冂 丶 一
主	丶 王
乃	丿 ㇆ ㇆
久	丿 入
幺	𠃊 厶
乍	丿 丅 二
乎	丿 丷 一 亅
乏	丿 之
乒	丘 丿
乓	丘 丶
乖	千 北
乘	禾 北
乜	卩 乚
九	丿 乙
乞	丿 一 乙
也	卩 丨 乚
乩	占 乙
乳	孚 乙
干	一 十
乱	舌 乙	舌 乚
了	乛 亅
予	龴 乛 亅
事	一 口 聿	一 口 肀
二	一 一
亍	一 丁
于	二 亅
云	二 厶
互	一 彑
亓	一 丌
五	二 丨 ㇆
井	二 丿 丨
亘	一 旦	二 日
些	此 二
亚	一 业
亟	丂 口 又 一
亡	丶 匸
亢	亠 几
交	亠 父
亦	亠 丿 亅 八
亨	亠 口 了
享	亠 口 子
京	亠 口 小
亭	亠 口 冖 丁
亮	亠 口 冖 儿
亳	亠 口 冂 乇
亶	亠 回 旦
人	丿 乀
什	人 十	亻 十
仁	人 二	亻 二
仂	人 力	亻 力
仃	人 丁	亻 丁
仄	厂 人
仆	人 卜	亻 卜
仇	人 九	亻 九
仉	人 几	亻 几
今	人 丶 乛
介	人 丿 丨
仍	人 乃	亻 乃
仔	人 子	亻 子
仕	人 士	亻 士
他	人 也	亻 也
仗	人 丈	亻 丈
付	人 寸	亻 寸
仙	人 山	亻 山
同	冂 一 口
仞	人 刃	亻 刃
仟	人 千	亻 千
仡	人 乞	亻 乞
代	人 弋	亻 弋
令	人 一 卩
仨	人 三	亻 三
仫	人 么	亻 么
仰	人 卬	亻 卬
仲	人 中	亻 中
仳	人 比	亻 比
仵	人 午	亻 午
件	人 牛	亻 牛
任	人 壬	亻 壬
份	人 分	亻 分
仿	人 方	亻 方
企	人 止
伉	人 亢	亻 亢
伊	人 尹	亻 尹
伋	人 及	亻 及
伍	人 五	亻 五
伎	人 支	亻 支
伏	人 犬	亻 犬
伐	人 戈	亻 戈
休	人 木	亻 木
伙	人 火	亻 火
伢	人 牙	亻 牙
伯	人 白	亻 白
估	人 古	亻 古
伴	人 半
伶	人 令	亻 令
伸	人 申	亻 申
伺	人 司	亻 司
似	人 以	亻 以
伽	人 加	亻 加
伾	人 丕	亻 丕
佃	人 田	亻 田
但	人 旦	亻 旦
伫	人 宀 一	亻 宀 一	人 宀 丁 佇	亻 宀 丁 佇
布	一 丿 巾
位	人 立	亻 立
低	人 氐	亻 氐
住	人 主	亻 主
佐	人 左	亻 左
佑	人 右	亻 右
何	人 可	亻 可
佗	人 它	亻 它
佘	人 示
余	人 于 八
佚	人 失	亻 失
佛	人 弗	亻 弗
作	人 乍	亻 乍
佝	人 句	亻 句
佞	人 二 女	亻 二 女
佟	人 冬	亻 冬
你	人 尔	亻 尔
佣	人 用	亻 用
佤	人 瓦	亻 瓦
佩	人 几 帀	亻 几 帀
佬	人 老	亻 老
佯	人 羊	亻 羊
佰	人 百	亻 百
佳	人 圭	亻 圭	人 土 土	亻 土 土
佴	人 耳	亻 耳
佶	人 吉	亻 吉
佻	人 兆	亻 兆
佼	人 交	亻 交
佾	人 八 月	亻 八 月	人 八 肉	亻 八 肉
使	人 吏	亻 吏
侃	人 口 川	亻 口 川
侄	人 至	亻 至
来	一 米
侈	人 多	亻 多
侉	人 夸	亻 夸
例	人 列	亻 列
侍	人 寺	亻 寺
侏	人 朱	亻 朱
侑	人 有	亻 有
侔	人 牟	亻 牟
仑	人 匕
侗	人 同	亻 同
供	人 共	亻 共
依	人 衣	亻 衣
价	人 介	亻 介
侮	人 每	亻 每
侯	人 乛 一 矢	亻 乛 一 矢
侵	人 彐 冖 又	亻 彐 冖 又
侣	人 吕	亻 吕
便	人 更	亻 更
俣	人 吴	亻 吴
系	丿 糸	丿 幺 小
促	人 足	亻 足
俄	人 我	亻 我
俅	人 求	亻 求
俊	人 夋	亻 夋
俎	人 人 且	仌 且
俏	人 肖	亻 肖
俐	人 利	亻 利
俑	人 甬	亻 甬
俗	人 谷	亻 谷
俘	人 孚	亻 孚
俚	人 里	亻 里
俜	人 甹	亻 甹
保	人 呆	亻 呆
俞	人 一 月 刀	人 一 月 刂
俟	人 矣	亻 矣
侠	人 夹	亻 夹
信	人 言	亻 言
修	攸 彡
俯	人 府	亻 府
俱	人 具	亻 具
俳	人 非	亻 非
俵	人 表	亻 表
俶	人 叔	亻 叔
俸	人 奉	亻 奉
俺	人 奄
俾	人 卑	亻 卑
伥	人 长	亻 长
俩	人 两	亻 两
仓	人 卩	人 㔾
个	人 丨
倌	人 官	亻 官
倍	人 咅	亻 咅	人 立 口	亻 立 口
倏	攸 犬
们	人 门	亻 门
倒	人 到	亻 到
倓	人 炎	亻 炎
倔	人 屈	亻 屈
幸	土 丷 二 丨	土 羊
倘	人 尚	亻 尚
候	人 丨 乛 一 矢	亻 丨 乛 一 矢	侯 丨
倚	人 奇	亻 奇
倜	人 周	亻 周
倞	人 京	亻 京
借	人 昔	亻 昔
倡	人 昌	亻 昌
倥	人 空	亻 空
倦	人 卷	亻 卷
倨	人 居	亻 居
倩	人 青	亻 青
倪	人 兒	亻 兒
伦	人 仑	亻 仑
倬	人 卓	亻 卓
倭	人 委	亻 委
俭	人 佥	亻 佥
倻	人 耶	亻 耶
值	人 直	亻 直
偃	人 匽	亻 匽	人 匚 妟	亻 匚 妟	人 匚 日 女	亻 匚 日 女
假	人 叚	亻 叚
偈	人 曷	亻 曷
伟	人 韦	亻 韦
偌	人 若	亻 若
偎	人 畏	亻 畏
偏	人 扁	亻 扁
偕	人 皆	亻 皆
做	人 故	亻 故
停	人 亭	亻 亭
健	人 建	亻 建
偬	人 怱	亻 怱
偲	人 思	亻 思
侧	人 则	亻 则
侦	人 贞	亻 贞
偶	人 禺	亻 禺
偷	人 俞	亻 俞
伪	人 为	亻 为
傀	人 鬼	亻 鬼
傅	人 甫 寸	亻 甫 寸	亻 尃
傈	人 栗	亻 栗
傍	人 旁
杰	木 火	木 灬
伧	人 仓	亻 仓
伞	人 丷 十
备	夂 田
家	宀 豕
傣	人 泰	亻 泰
催	人 崔	亻 崔
傲	人 敖
传	人 专	亻 专
伛	人 区	亻 区
债	人 责	亻 责
伤	人 丿 一 力	亻 丿 一 力
傻	人 囟 儿 夕	亻 囟 儿 夂
倾	人 顷	亻 顷
偻	人 娄	亻 娄
仅	人 又	亻 又
僇	人 翏	亻 翏
佥	人 一 小 一
像	人 象	亻 象
侨	人 乔	亻 乔
僖	人 喜	亻 喜
僚	人 尞	亻 尞
侥	人 尧	亻 尧
僦	人 就	亻 就
僧	人 曽	亻 曽	人 曾	亻 曾
偾	人 贲	亻 贲
僬	人 焦	亻 焦
僭	人 朁	亻 朁
僮	人 童	亻 童
僰	棘 人
雇	户 隹
僳	人 粟	亻 粟
僵	人 畺	亻 畺
僻	人 辟	亻 辟
仪	人 义	亻 义
侬	人 农	亻 农
亿	人 乙	亻 乙
儆	人 敬	亻 敬
儇	人 睘	亻 睘
侩	人 会	亻 会
儋	人 詹	亻 詹
傧	人 宾	亻 宾
儒	人 需	亻 需
俦	人 寿	亻 寿
侪	人 齐	亻 齐
尽	尺 冰	尺 冫
偿	人 尝	亻 尝
儡	人 畾	亻 畾	人 田 田 田	亻 田 田 田
优	人 尤	亻 尤
储	人 诸	亻 诸
俪	人 丽	亻 丽
傩	人 难	亻 难
傥	人 党	亻 党
俨	人 严	亻 严
兀	一 儿
允	厶 儿
元	二 儿
兄	口 儿
充	亠 允
兆	儿 丷 八	冰 儿 丶 丶	冫 儿 丶 丶
凶	凵 乂
先	丿 土 儿
光	小 兀
兑	丷 兄	丷 口 儿
克	十 兄	十 口 儿
免	刀 口 丨 儿
兔	刀 口 丨 儿 丶
儿	丿 乚
兕	凹 儿
兖	亠 兊
兜	匚 白 ㇆ 一 儿
兢	克 克
入	乁 丿
内	冂 人
全	人 王
两	一 冂 丨 人 人
八	丿 乁
公	八 厶
六	亠 八
兮	八 丂
共	井 八	十 丨 一 八	二 丨 丨 八
兵	丘 八
其	甘 一 八
具	目 一 八
典	曲 八
兼	丷 一 彐 丨 丨 八	丷 一 聿 丨 丨 八	丷 一 肀 丨 丨 八
艺	草 乙	艸 乙	艹 乙
冀	北 異
圆	囗 员
冉	冂 十 一
册	⺆ ⺆ 一
再	一 冂 十 一
冒	冃 目	冂 二 目	曰 目	日 目
冕	冃 勉	冂 二 勉	曰 勉	日 勉
冗	冖 几
冠	冖 元 寸
冢	冖 豖
冤	冖 兔
冥	冖 日 大
幂	冖 日 大 巾
冬	夕 冰	夂 冫
冰	冰 水	冫 水
冱	冰 互	冫 互
冶	冰 台	冫 台
冷	冰 令	冫 令
冼	冰 先	冫 先
冽	冰 列	冫 列
准	冰 隹	冫 隹
凇	冰 松	冫 松
净	冰 争	冫 争
凋	冰 周	冫 周
凌	冰 夌	冫 夌
冻	冰 东	冫 东
凛	冰 禀	冫 禀
凝	冰 疑	冫 疑
几	丿 乙
凡	几 丶
处	夕 卜	夂 卜
凰	几 皇
凯	岂 几
凳	登 几
出	山 山	山 凵	凵 丨 凵
凼	凵 水
函	凵 氶
刀	㇆ 丿
刃	刀 丶
分	八 刀
切	七 刀
刈	乂 刀	乂 刂
刊	干 刀	干 刂
刍	刀 彐
刎	勿 刀	勿 刂
刑	开 刀	开 刂
划	戈 刀	戈 刂
刖	月 刀	月 刂
列	歹 刀	歹 刂
初	衣 刀	衤 刀
判	半 刀	半 刂
别	另 刀	另 刂
劫	去 力
刨	包 刀	包 刂
利	禾 刀	禾 刂
删	册 刀	册 刂
刮	舌 刀	舌 刂
到	至 刀	至 刂
刳	夸 刀	夸 刂
剁	朵 刀	朵 刂
制	丿 二 巾 刀	丿 二 巾 刂
刷	尸 巾 刀	尸 巾 刂
券	丷 夫 刀	𠔉 刀
刺	朿 刀	朿 刂	木 冂 刀	木 冂 刂
刻	亥 刀	亥 刂
剃	弟 刀	弟 刂
刭	圣 刀	圣 刂
剅	豆 刀	豆 刂
则	贝 刀	贝 刂
削	肖 刀	肖 刂
剌	束 刀	束 刂
前	丷 一 肉 刀	丷 一 月 刂
刹	杀 刀	杀 刂
剔	易 刀	易 刂
剕	非 刀	非 刂
剖	咅 刀	咅 刂	立 口 刀	立 口 刂
刚	冈 刀	冈 刂
剜	宛 刀	宛 刂
剥	录 刀	录 刂
剞	奇 刀	奇 刂
剟	叕 刀	叕 刂
剡	炎 刀	炎 刂
剑	佥 刀	佥 刂
剂	齐 刀	齐 刂
剩	乘 刀	乘 刂
剪	前 刀
剐	呙 刀	呙 刂
副	畐 刀	畐 刂
割	害 刀	害 刂
剀	岂 刀	岂 刂
创	仓 刀	仓 刂
剽	票 刀	票 刂
剿	巢 刀	巢 刂
劁	焦 刀	焦 刂
劂	厥 刀	厥 刂
剧	居 刀	居 刂
劈	辟 刀
刘	文 刀	文 刂
刽	会 刀	会 刂
刿	岁 刀	岁 刂
劐	蒦 刀	蒦 刂
劓	鼻 刀	鼻 刂
力	丿 ㇆
功	工 力
加	力 口
劣	少 力
助	且 力
努	奴 力
劬	句 力
劭	召 力
劳	草 冖 力	艸 冖 力	艹 冖 力
劾	亥 力
劲	圣 力
勃	孛 力
勇	甬 力
勉	免 力
勍	京 力
勐	孟 力
勒	革 力
动	云 力
勖	冒 力
勘	甚 力
务	夕 力	夂 力
勋	员 力
胜	肉 生	月 生
募	莫 力
势	埶 力 勢	执 力 勢
勤	堇 力
劝	又 力
勚	贳 力
勰	劦 思
劢	万 力
励	厉 力
勺	勹 丶
匀	勹 冰	勹 冫
勾	勹 厶
勿	勹 丿 丿
包	勹 己
匆	勿 丶
匈	勹 凶
匏	夸 包
匐	勹 畐
匕	乚 丿
化	人 匕	亻 匕
北	丬 匕
匙	是 匕
匜	匚 也
匝	匚 巾
匠	匚 斤
匡	匚 王
匣	匚 甲
匪	匚 非
匦	匚 轨
汇	水 匚	氵 匚
匮	匚 贵
匹	匸 儿	匚 儿
匾	匸 扁	匚 扁
匿	匸 若	匚 若
区	匸 乂	匚 乂
十	一 丨
千	丿 十
卅	川 一
升	千 丨	丿 十 丿
午	丿 干
卉	十 廾
半	丷 一 十	八 一 十
卑	丶 田 丿 十
卒	亠 人 十
卓	卜 日 十
协	十 办
南	十 冂 丫 二
博	十 尃	十 甫 寸
卜	丨 丶
卞	丶 下
卟	口 卜
占	卜 口
卡	上 卜	上 下
卣	卜 囙
卦	圭 卜
卮	厂 一 卩
卯	卬 丿	匸 丿 卩
印	卬 一	匸 一 卩
危	厃 卩	刀 厂 卩	厃 㔾	刀 厂 㔾
即	艮 卩
卵	卯 丶 丶	匸 丿 丶 卪
卷	丷 夫 卩	𠔉 㔾
卺	丞 卩	丞 㔾
却	去 卩
卿	卯 艮 卩	匸 丿 即
厄	厂 卩	厂 㔾
厍	厂 车
厚	厂 日 子
厅	厂 丁
厝	厂 昔
原	厂 白 小	厂 泉
厥	厂 欮
厌	厂 犬
厉	厂 万
严	亚 丿
厣	厌 甲	厂 犬 甲
去	土 厶
厾	乁 去
参	厶 大 彡
叁	厶 大 三
叉	又 丶
及	乃 乀
友	一 丿 又
反	厂 又
叔	上 小 又	尗 又
取	耳 又
受	爪 冖 又	爫 冖 又
叛	半 反
叟	臼 丨 又
丛	从 一
口	丨 乛 一	冂 一
古	十 口
句	勹 口
另	口 力
叨	口 刀
叩	口 卩
只	口 八
叫	口 丩
召	刀 口
叭	口 八
叮	口 丁
可	一 口 亅	丁 口
台	厶 口
叱	口 匕
史	口 乂
右	一 丿 口
叵	匚 口
司	㇆ 一 口
叻	口 力
叼	口 刁
吁	口 于
吃	口 乞
各	夂 口
吆	口 幺
合	人 一 口
吉	士 口
名	夕 口
后	厂 一 口
吏	一 口 乂	一 口 丿 乀
吐	口 土
向	丶 冂 口
咤	口 宅 吒
吓	口 下
君	尹 口
吝	文 口
吞	天 口
吟	口 今
吠	口 犬
吡	口 比
吣	口 心
否	不 口
吧	口 巴
吩	口 分
含	今 口
吭	口 亢
吮	口 允
吱	口 支
吲	口 引
吴	口 天
吵	口 少
呐	口 内
吸	口 及
吹	口 欠
吻	口 勿
吼	口 孔
吾	五 口
呀	口 牙
吕	口 口
呃	口 厄
呆	口 木
呈	口 王
告	牛 口
呋	口 夫
呔	口 太
呢	口 尼
呤	口 令
呦	口 幼
周	冂 土 口
呱	口 瓜
呲	口 此
味	口 未
呵	口 可
呶	口 奴
呷	口 甲
呸	口 丕	口 不 一
呻	口 申
呼	口 乎
命	人 一 叩
咀	口 且
咂	口 匝
咄	口 出
咆	口 包
咋	口 乍
和	禾 口
咎	久 人 口	夂 人 口
咐	口 付
咒	口 口 几
咔	口 卡
咕	口 古
咖	口 加
咚	口 冬
咣	口 光
咦	口 夷
咧	口 列
咨	次 口
咩	口 羊
咪	口 米
咫	尺 只
咬	口 交
咭	口 吉
咯	口 各
咱	口 自
咳	口 亥
咴	口 灰
咸	戊 一 口
咻	口 休
呙	口 内
咽	口 因
咿	口 伊
哀	衣 口
品	口 口 口
哂	口 西
哄	口 共
哆	口 多
哇	口 圭	口 土 土
哈	口 合
哉	十 戈 口	土 戈 口	𢦏 口
哌	口 厂 氏
响	口 向
哎	口 艾
哏	口 艮
哐	口 匡
哚	口 朵
哞	口 牟
员	口 贝
哥	可 可
哦	口 我
哧	口 赤
哨	口 肖
哩	口 里
哪	口 那
哭	口 口 犬
哮	口 孝
哲	折 口
哳	口 折
哺	口 甫
哼	口 享
哽	口 更
哿	加 可
唁	口 言
呗	口 贝
唆	口 夋
唇	口 辰
唉	口 矣
唏	口 希
唐	广 肀 口	广 聿 口
唑	口 坐
唔	口 吾
哑	口 亚
唣	口 皂
唧	口 即
唪	口 奉
唬	口 虎
售	隹 口
唯	口 隹
唱	口 昌
唳	口 戻
唷	口 育
念	今 心
唼	口 妾
唾	口 垂
唿	口 忽
啁	口 周
啃	口 肯
啄	口 豖
商	亠 丷 冂 儿 口	亠 丷 冏
啉	口 林
啊	口 阿
问	门 口
啐	口 卒
启	户 口
啕	口 匋
啖	口 炎
啜	口 叕
啡	口 非
啤	口 卑
啥	口 舍
啦	口 拉
啪	口 拍
啵	口 波
啶	口 定
啷	口 郎
啻	帝 口
啼	口 帝
啾	口 秋
喀	口 客
喁	口 禺
喂	口 畏
喃	口 南
善	羊 丷 一 口
喇	口 剌
喈	口 皆
喉	口 侯
喊	口 咸
喋	口 枼	口 世 木
喏	口 若
喑	口 音
喔	口 屋
喘	口 耑	口 山 而
喙	口 彖
唤	口 奂
喜	士 口 丷 一 口
喝	口 曷
喟	口 胃
喤	口 皇
喧	口 宣
乔	夭 丿 丨
单	丷 甲 一
喱	口 厘
哟	口 约 喲
喳	口 查
喵	口 苗
营	草 冖 吕	艸 冖 吕	艹 冖 吕
喹	口 奎
喻	口 俞
嗄	口 夏
嗅	口 臭
呛	口 仓
啬	土 丷 回
嗉	口 素
唝	口 贡
嗌	口 益
嗍	口 朔
吗	口 马
嗑	口 盍	口 去 皿
嗒	口 荅
嗓	口 桑
嗔	口 真
嗖	口 叟
呜	口 乌
嗜	口 耆	口 老 日
嗝	口 鬲
嗞	口 兹
嗟	口 差
嗡	口 翁
嗣	口 冊 司
嗤	口 蚩
嗥	口 皋
嗦	口 索
嗨	口 海
唢	口 小 贝
嗪	口 秦
嗬	口 荷
嗯	口 恩
嗲	口 爹
嗵	口 通
哔	口 毕
嗷	口 敖
嗽	口 欶	口 束 欠
嗾	口 族
嘀	口 啇
嘁	口 戚
叹	口 又
嘈	口 曹
嘉	吉 丷 一 加	士 口 丷 一 加
嘌	口 票
喽	口 娄
嘎	口 戛
嘏	古 叚
呕	口 区
啧	口 责
尝	小 冖 云
嘚	口 得
嘛	口 麻
唛	口 麦
嘞	口 勒
嘟	口 都
嘡	口 堂
嘣	口 朋
嘧	口 密
啸	口 肃
哗	口 华
嘬	口 最
嘭	口 彭
唠	口 劳
叽	口 几
嘲	口 朝
嘴	口 觜
哓	口 尧
嘶	口 斯
嘹	口 尞
嘻	口 喜
啴	口 单
嘿	口 黑
噀	口 巽
恶	亚 心
噌	口 曽	口 曾
噍	口 焦
噎	口 壹
嘘	口 虚
噔	口 登
噗	口 菐
噙	口 禽
啮	口 齿
咝	口 丝
噢	口 奥
噤	口 禁
哝	口 农
哕	口 岁
器	口 口 大 口 口
噩	王 口 口 口 口	一 口 口 一 口 口 一 丨
噪	口 喿	口 品 木
噫	口 意
噬	口 筮
嗳	口 爱
噱	口 豦
哙	口 会
喷	口 贲
噶	口 葛
吨	口 屯
当	小 彐
噻	口 塞
噼	口 辟
咛	口 宁
嚄	口 蒦
嚅	口 需
嚆	口 蒿
嚎	口 豪
嚏	口 疐
嚓	口 察
噜	口 鲁
嚚	口 口 臣 口 口
呖	口 历
咙	口 龙
嚯	口 霍
亸	享 单
喾	小 冖 告
嘤	口 婴
嚷	口 襄
嚼	口 爵
啭	口 转
嗫	口 聂
嚣	口 口 页 口 口
冁	单 展
呓	口 艺
啰	口 罗
囊	一 口 丨 冂 口 口 井 一 
苏	草 办	艸 办	艹 办
嘱	口 属
囔	口 囊
回	囗 口
囚	囗 人
四	囗 儿
囝	囗 子
囟	丶 囗 乂
因	囗 大
囡	囗 女
囤	囗 屯
囫	囗 勿
困	囗 木
囱	丶 囗 夕
围	囗 韦
图	囗 冬
囹	囗 令
固	囗 古
囿	囗 有
圃	囗 甫
圄	囗 吾
囵	囗 仑
圈	囗 卷
圉	囗 幸
圊	囗 青
国	囗 玉
园	囗 元
团	囗 才
圜	囗 睘
土	十 一
压	厂 圡
在	一 人 土	一 亻 土
圩	土 于
圪	土 乞
圬	土 亏
圭	土 土
圮	土 己
圯	土 已	土 巳
地	土 也
圳	土 川
圻	土 斤
圾	土 及
址	土 止
坂	土 反
均	土 匀
坊	土 方
坌	土 分
坍	土 丹
坎	土 欠
坐	人 人 土
坑	土 亢
坡	土 皮
坤	土 申
坦	土 旦
坨	土 它
坩	土 甘
坪	土 平
坫	土 占
坭	土 尼
坯	土 丕
坳	土 幼
坷	土 可
坻	土 氐
坼	土 斥
垂	丿 二 土 丨 丨
垃	土 立
型	刑 土
垌	土 同
垍	土 自
垓	土 亥
垛	土 朵
垞	土 宅
垟	土 羊
垠	土 艮
垡	伐 土
垢	土 后
垣	土 亘
垤	土 至
垧	土 向
垮	土 夸
垸	土 完
坝	土 贝
埂	土 更
埃	土 矣
埋	土 里
城	土 成
埏	土 延
埒	土 寽
埔	土 甫
埕	土 呈
埝	土 念
域	土 或
埠	土 阜
垭	土 亚
埭	土 隶
埯	土 奄
埴	土 直
执	手 丸	扌 丸	才 丸
埸	土 易
培	土 咅
基	其 土
埼	土 奇
埽	土 帚
堂	尚 土
昆	日 比
坚	丨 丨 又 土
堆	土 隹
堇	廿 口 丰
堉	土 育
垩	亚 土
堋	土 朋
堌	土 固
堍	土 兔
堙	土 西 土
埚	土 呙
堞	土 枼
堠	土 侯
堡	保 土
堤	土 是
堪	土 甚
堰	土 匽
报	手 卩 又	扌 卩 又	才 卩 又
场	土 弓 丿 丿
堵	土 者
塃	土 荒
塄	土 目 方	土 罒 方
塈	既 土
块	土 夬
茔	草 冖 土	艸 冖 土	艹 冖 土
塌	土 日 羽	土 曰 羽
塍	肉 丷 夫 土	月 丷 夫 土	肉 𠔉 土	月 𠔉 土
垲	土 岂
塑	朔 土
埘	土 时
塔	土 荅
涂	水 余	氵 余 土 塗	氵 余
塘	土 唐
塞	宀 井 大 土
填	土 真
坞	土 乌
埙	土 员
塥	土 鬲
盐	土 卜 皿
塬	土 原
塮	土 射
尘	小 土
堑	斩 土
塾	孰 土
墀	土 犀
墁	土 曼
境	土 竟
墅	野 土
墈	土 勘
墉	土 庸
垫	执 土
墒	土 商
墓	莫 土
增	土 曾
坠	队 土
墟	土 虚
墦	土 番
墨	黑 土
墩	土 敦
堕	陏 土
坟	土 文
墙	土 啬
垦	艮 土
壁	辟 土
壅	雍 土
坛	土 云
坏	土 不
垱	土 当
壑	卜 冖 一 谷 又 土
壕	土 豪
垒	厽 土	厶 厶 厶 土
圹	土 广
垆	土 卢
垄	土 龙
垅	土 龙
坜	土 历
壤	土 襄
士	十 一
壬	丿 士
壮	丬 士
卖	十 买
壶	士 冖 业
壹	士 冖 豆
寿	丰 寸
变	亦 又
夏	一 自 夕	一 自 夂
夔	丷 一 止 自 卩 夕	丷 一 止 自 卩 夂
夕	丿 丿 丶
外	夕 卜
夙	几 歹
多	夕 夕
夜	亠 人 夕 丶	亠 亻 夕 丶
够	句 多
梦	木 木 夕
夤	夕 寅
夥	果 多
大	人 一
天	一 大
太	大 丶
夫	一 大	二 人
夬	乛 大
夭	丿 大
央	冂 大
夯	大 力
失	丿 夫	丶 夫
夷	大 弓	一 弓 人
夸	大 亏
夼	大 川
夹	一 丷 大
奄	大 电
奇	大 可
奈	大 示
奉	手 乀 一 十	龹 一 十
奎	大 圭	大 土 土
奏	手 乀 夭	龹 夭
奂	刀 冂 大
契	丰 刀 大
奔	大 卉
奕	亦 大
套	大 镸
奘	壯 大
奚	爪 幺 大	爫 幺 大
奠	酋 大
奢	大 者
奥	丶 冂 米 大
奖	丬 夕 大
奁	大 区
夺	大 寸
奭	大 百 百
奋	大 田
女	𠃊 一 丿
奴	女 又
奶	女 乃
奸	女 干
她	女 也
好	女 子
妁	女 勺
如	女 口
妃	女 己
妄	亡 女
妊	女 壬
妍	女 开
妒	女 戶	女 户	女 戸
妓	女 支
妖	女 夭
妗	女 今
妙	女 少
妆	丬 女
妞	女 丑
妣	女 比
妤	女 予
妥	爪 女	爫 女
妨	女 方
妮	女 尼
妯	女 由
妲	女 旦
妹	女 未
妻	一 聿 女	一 肀 女
妾	立 女
姆	女 母
姊	女 丿 ㇉ 丨 丿
始	女 台
姗	女 册
姐	女 且
姑	女 古
姒	女 以
姓	女 生
委	禾 女
姘	女 并
姚	女 兆
姜	羊 女
姝	女 朱
姞	女 吉
姣	女 交
姥	女 老
姨	女 夷
姬	女 匸 丨 口 丨
姹	女 宅
姻	女 因
姽	女 危
姿	次 女
威	戊 一 女
娃	女 圭	女 土 土
娉	女 甹
娌	女 里
娑	沙 女
娓	女 尾
娘	女 良
娱	女 吴
娜	女 那
娟	女 肙	女 口 月
娠	女 辰
娣	女 弟
娥	女 我
娩	女 免
娶	取 女
娼	女 昌
婀	女 阿
娄	米 女
婆	波 女
婉	女 宛
婊	女 表
婕	女 疌
婚	女 昏
婞	女 幸
婢	女 卑
妇	女 彐
婧	女 青
婪	林 女	木 木 女
娅	女 亚
婷	女 亭
婺	敄 女
婿	女 胥
媒	女 某
媚	女 眉
媛	女 爰
娲	女 呙
妫	女 为
媲	女 囟 比
媳	女 息
媵	肉 丷 夫 女	月 丷 夫 女	肉 𠔉 女	月 𠔉 女
媸	女 蚩
媪	女 昷
妈	女 马
媾	女 冓
嫁	女 家
嫂	女 叟
嫉	女 疾
嫌	女 兼
嫖	女 票
妪	女 区
嫘	女 累
嫚	女 曼
嫜	女 章
嫠	未 攵 厂 女
嫡	女 啇
嫣	女 焉
嫦	女 常
嫩	女 敕
嫪	女 翏
嫫	女 莫
妩	女 无
娴	女 闲
婳	女 画
娆	女 尧
嬉	女 喜
婵	女 单
娇	女 乔
嬖	辟 女
嬗	女 亶
嫱	女 啬
嫒	女 爱
嬷	女 麽
嫔	女 宾
婴	贝 贝 女
嬴	亡 口 月 女 凡
婶	女 审
孀	女 霜
娈	亦 女
子	了 一
孑	了 丿
孓	了 乀
孔	子 乙
孕	乃 子
字	宀 子
存	一 人 子	一 亻 子
孚	爪 子	爫 子
孛	十 冖 子
孜	子 攴	子 攵
孝	老 子	耂 子
孟	子 皿
孢	子 包
季	禾 子
孤	子 瓜
孥	奴 子
孩	子 亥
孙	子 小
孬	不 好
孰	享 丸
孱	尸 孨	尸 子 子 子
孵	卵 孚
孳	兹 子
学	小 冖 子
孺	子 需
孽	薛 子
孪	亦 子
它	宀 匕
宄	宀 九
宅	宀 乇
宇	宀 于
守	宀 寸
安	宀 女
宋	宀 木
完	宀 元
宏	宀 厷
宓	宀 必
宕	宀 石
宗	宀 示
官	宀 㠯
宙	宀 由
定	宀 疋
宛	宀 夗
宜	宀 且
实	宀 头
客	宀 各
宣	宀 亘
室	宀 至
宥	宀 有
宦	宀 臣
宬	宀 成
宫	宀 吕	宀 口 口
宰	宀 辛
害	宀 丰 口
宴	宀 妟
宵	宀 肖
宸	宀 辰
容	宀 谷
宿	宀 人 百	宀 亻 百
寂	宀 叔
寄	宀 奇
寅	宀 一 由 八
密	宀 必 山	宓 山
寇	宀 元 攴
富	宀 畐
寐	宀 爿 未
寒	宀 井 大 冰	宀 井 大 冫
寓	宀 禺
宽	宀 草 见	宀 艸 见	宀 艹 见
宁	宀 丁
寞	宀 莫
察	宀 祭
寡	宀 直 分
寝	宀 丬 彐 冖 又
寤	宀 爿 吾
寥	宀 翏
寨	宀 一 共 木	宀 井 大 木
审	宀 申
写	冖 与
寮	宀 尞
寰	宀 睘
宝	宀 玉
宠	宀 龙
寸	一 亅 丶
寺	土 寸
对	又 寸
封	土 土 寸	圭 寸
专	二 丨 龴
射	身 寸
将	爿 肉 寸 將	丬 夕 寸
尉	尸 示 寸
尊	酋 寸
寻	彐 寸
导	巳 寸
小	八 亅
少	小 丿
尕	乃 小
尖	小 大
尚	小 冋	小 冂 口
尜	小 大 小
尤	尢 丶	一 丿 乚 丶
尥	尢 勺
尬	尢 介
就	京 尤
尴	尢 监
尸	㇆ 一 丿
尹	尸 一	彐 丿
尺	尸 乀
尻	尸 九
尼	尸 匕
尾	尸 毛
尿	尸 水
局	尸 ㇆ 口
屁	尸 比
居	尸 古
届	尸 由
屈	尸 出
屋	尸 至
屎	尸 米
屏	尸 并
屐	尸 彳 支
屑	尸 肖
屃	尸 贝
展	尸 龷 
屙	尸 阿
屉	尸 世
屠	尸 者
屡	尸 娄
屣	尸 徙
层	尸 云
履	尸 復
屦	尸 彳 娄
属	尸 禹
屯	丿 凵 乚
山	凵 丨
屹	山 乞
屺	山 己
岈	山 牙
岌	山 及
岍	山 开
岐	山 支
岑	山 今
岔	分 山
岙	夭 山
冈	冂 乂
岢	山 可
岣	山 句
岩	山 石
岫	山 由
岬	山 甲
岱	代 山
岳	丘 山
岵	山 古
岷	山 民
岸	山 厈
峁	山 卯
峂	山 冬
峋	山 旬
峒	山 同
峙	山 寺
峧	山 交
峨	山 我
峪	山 谷
峭	山 肖
峰	山 夆
岘	山 见
岛	勹 丶 勹 山
峻	山 夋
峡	山 夹
崆	山 空
崇	山 宗
崃	山 来
崎	山 奇
崔	山 隹
崖	山 厓
岗	山 冈
崛	山 屈
崞	山 享
崟	山 金
峥	山 争
崤	山 肴
崦	山 奄
崩	山 朋
崮	山 固
崴	山 威
崽	山 思
嵇	禾 尤 山
嵊	山 乘
嵋	山 眉
嵌	山 甘 欠
嵎	山 禺
岚	山 风
嵖	山 查
嵛	山 俞
嵩	山 高
嵫	山 兹
嵬	山 鬼
嵯	山 差
嵴	山 脊
嵝	山 娄
嶂	山 章
崭	山 斩
岖	山 区
嶓	山 番
嵚	山 钦
崂	山 劳
嶙	山 粦
嶝	山 登
峤	山 乔
峣	山 尧
峄	山 又 二 丨
隽	隹 乃
嶷	山 疑
嵘	山 荣
岭	山 令
屿	山 与
巉	山 毚
岿	山 归
巍	山 魏
峦	亦 山
巅	山 顛 巔
川	丿 丨 丨
州	川 丶 丶 丶
巡	辵 巛	辶 巛
巢	巛 果
工	二 丨	一 丨 一
左	一 丿 工
巧	工 丂	工 万
巨	匚 乛 一	匸 ㇆ 一
巫	工 人 人
差	羊 丿 工
巯	圣 亠 厶 川	圣 巟	圣 㐬
己	㇆ 一 乚
已	㇆ 一 乚
巳	㇆ 一 乚
巴	巳 丨	巳 丶
巷	共 己
巽	己 己 共
巾	冂 丨
市	亠 巾
帆	巾 凡
希	乂 布	乂 一 丿 巾
帑	奴 巾
帔	巾 皮
帕	巾 白
帖	巾 占
帘	奴 巾
帙	巾 失
帚	彐 冖 巾
帛	白 巾
帝	亠 丷 冖 巾
帅	丨 丿 巾
师	丨 丿 帀
席	广 廿 巾
帡	巾 并
帐	巾 长
带	卅 冖 巾
帷	巾 隹
常	尚 巾
帽	巾 冒
帧	巾 贞
帏	巾 韦
幄	巾 屋
幅	巾 畐
帮	邦 巾
幌	巾 晃
幔	巾 曼
幕	莫 巾
帼	巾 国
帻	巾 责
幞	巾 菐
帜	巾 只
幡	巾 番
幢	巾 童
币	丿 巾	一 巾
幪	巾 蒙
帱	巾 寿
平	干 丷
年	丿 丰 丶	丿 一 二 丶 丨
幻	幺 ㇆
幼	幺 力
幽	山 幺 幺
庀	匕
广	丶 一 丿
庇	广 比
床	广 木
庋	广 支
序	广 予
底	广 氐
庖	广 包
店	广 占
庚	广 彐 人	广 肀 人
府	广 付
庠	广 羊
庤	广 寺
庥	广 休
度	广 廿 又
座	广 坐
库	广 车
庭	广 廷
庳	广 卑
庵	广 奄
庶	广 廿 火	广 廿 灬
康	广 隶
庸	广 聿 冃	广 聿 冂 二	广 肀 冂 二	广 用 冂 二
庹	广 廿 尺
庾	广 臾
厕	厂 则
厢	厂 相 廂
废	广 发
厩	厂 既
厦	厂 夏
廉	广 兼
廊	广 郎
庼	广 顷
廒	广 敖
廓	广 郭
廖	广 翏
厨	厂 豆 寸
廛	广 里 儿 土
厮	厂 斯 廝
庙	广 朝 廟	广 由 廟
厂	一 丿
庑	广 无
廨	广 解
廪	广 禀
庐	广 户
延	廴 丿 止
廷	廴 壬
建	廴 聿
廿	一 凵
弁	厶 廾
弄	王 廾
弇	合 廾
弈	亦 廾
弊	敝 廾
弋	一 乁 丶
式	弋 工
弑	杀 式 弒
弓	㇆ 一 ㇉
吊	口 巾
引	弓 丨
弗	弓 丿 丨
弘	弓 厶
弛	弓 也
弟	丷 弔 丿	丷 弓 丨 丿
弦	弓 玄
弧	弓 瓜
弩	奴 弓
弭	弓 耳
弱	弓 冰 弓 冰	弓 冫 弓 冫
张	弓 长
强	弓 虽
弼	弓 百 弓
弹	弓 单
彀	士 冖 一 弓 殳
弥	弓 尔
弯	亦 弓
录	彐 水
彖	彑 豕
彗	丰 丰 彐
彘	彑 比 矢	彑 匕 矢 匕
彝	彑 米 糸 廾
形	开 彡
彤	丹 彡
彦	亠 丷 厂 彡
彧	或 彡	或 丿 丿
彩	采 彡
彪	虎 彡
雕	周 隹
彬	林 彡
彭	壴 彡
彰	章 彡
影	景 彡
彳	丿 人	丿 亻
役	彳 殳
彼	彳 皮
往	彳 主
征	彳 正
徂	彳 且
待	彳 寺
徇	彳 旬
很	彳 艮
徉	彳 羊
徊	彳 回
律	彳 聿
徐	彳 余
径	彳 圣
徒	彳 走
从	人 人
得	彳 日 一 寸
徘	彳 非
徙	彳 歨	彳 止 疋
徕	彳 来
御	彳 卸
徨	彳 皇
复	丿 一 日 夕	丿 一 日 夂
循	彳 盾
微	彳 山 兀 攴	彳 山 兀 攵
德	彳 十 网 一 心	彳 十 罒 一 心
彻	彳 切
徼	彳 敫
徽	彳 山 糸 攴	彳 山 糸 攵
心	丿 乚 丶 丶
必	心 丿
忉	心 刀	忄 刀
忌	己 心
忍	刃 心
忐	上 心
忑	下 心
忒	弋 心
忖	心 寸	忄 寸
志	士 心
忘	亡 心
忙	心 亡	忄 亡
应	广 小 一
忝	天 心
忠	中 心
忡	心 中	忄 中
忤	心 午	忄 午
忪	心 公	忄 公
快	心 夬	忄 夬
忭	心 卞	忄 卞
忮	心 支	忄 支
忱	心 冘	忄 冘
忸	心 丑	忄 丑
忻	心 斤	忄 斤
忽	勿 心
忿	分 心
怊	心 召	忄 召
怍	心 乍	忄 乍
怎	乍 心
怏	心 央	忄 央
怒	奴 心
怔	心 正	忄 正
怕	心 白	忄 白
怖	心 布	忄 布
怙	心 古	忄 古
怛	心 旦	忄 旦
思	田 心
怠	台 心
怡	心 台	忄 台
急	刍 心
怦	心 平	忄 平
性	心 生	忄 生
怨	夗 心	夕 卩 心	夕 㔾 心
怩	心 尼	忄 尼
怪	心 圣	忄 圣
怫	心 弗	忄 弗
怯	心 去	忄 去
怵	心 术	忄 术
恁	任 心
恂	心 旬	忄 旬
恃	心 寺	忄 寺
恒	心 亘	忄 亘
恍	心 光	忄 光
恐	巩 心	工 凡 心
恕	女 口 心
恙	羊 心
恚	圭 心
恝	丰 刀 心
恢	心 灰	忄 灰
恣	次 心
恤	心 血	忄 血
耻	耳 止
恧	而 心
恨	心 艮	忄 艮
恩	因 心
恪	心 各	忄 各
恫	心 同	忄 同
恬	心 舌	忄 舌
恭	共 心	共 小 丶
息	自 心
恰	心 合	忄 合
惠	叀 心
悃	心 困	忄 困
悄	心 肖	忄 肖
悦	心 兑	忄 兑
悉	采 心	釆 心
悌	心 弟	忄 弟
悍	心 旱	忄 旱
悒	心 邑	忄 邑
悔	心 每	忄 每
悖	心 孛	忄 孛
悚	心 束	忄 束
悛	心 夋	忄 夋
悝	心 里	忄 里
悟	心 吾	忄 吾
悠	攸 心
悢	心 良	忄 良
患	串 心
您	你 心
恼	心 亠 乂 凵	忄 亠 乂 凵
悱	心 非	忄 非
悲	非 心
悴	心 卒	忄 卒
怅	心 长	忄 长
闷	门 心
悸	心 季	忄 季
悻	心 幸	忄 幸
悼	心 卓	忄 卓
情	心 青	忄 青
惆	心 周	忄 周
惇	心 享	忄 享
惋	心 宛	忄 宛
惑	或 心
惕	心 易	忄 易
惘	心 罔	忄 罔
惚	心 忽	忄 忽
惜	心 昔	忄 昔
惝	心 尚	忄 尚
惟	心 隹	忄 隹
惦	心 店	忄 店
惰	心 左 肉	忄 左 月
恽	心 军	忄 军
想	相 心
惴	心 耑	忄 耑	心 山 而	忄 山 而
惶	心 皇	忄 皇
惹	若 心
惺	心 星	忄 星
恻	心 则	忄 则
愀	心 秋	忄 秋
愁	秋 心
愆	衍 心
愈	俞 心
愉	心 俞	忄 俞
愎	心 复	忄 复
意	音 心
愔	心 音	忄 音
愕	心 咢	忄 咢
愚	禺 心
爱	爪 冖 友	爫 冖 友
惬	心 匧	忄 匧
感	咸 心
愣	心 网 方	忄 罒 方
愧	心 鬼	忄 鬼
愫	心 素	忄 素
怆	心 仓	忄 仓
恺	心 岂	忄 岂
慎	心 真	忄 真
忾	心 气	忄 气
恿	甬 心
栗	西 木
慈	茲 心
慊	心 丶 丶 兼	忄 丶 丶 兼
态	太 心
慌	心 荒	忄 荒
愠	心 昷	忄 昷
慕	莫 心	莫 小 丶
惨	心 参	忄 参
惭	心 斩	忄 斩
慝	匿 心
恸	心 动	忄 动
慢	心 曼	忄 曼
惯	心 贯	忄 贯
悫	壳 心
慥	心 造	忄 造
慧	彗 心
慨	心 既	忄 既
怄	心 区	忄 区
怂	从 心
虑	虎 心	虍 心
慰	尉 心
悭	心 坚	忄 坚
慵	心 庸	忄 庸
庆	广 大
慷	心 康	忄 康
欲	谷 欠
忧	心 尤	忄 尤
惫	备 心
憋	敝 心
憎	心 曽	忄 曽	心 曾	忄 曾
怜	心 令	忄 令
凭	任 几
愦	心 贵	忄 贵
憔	心 焦	忄 焦
慭	来 犬 心
惮	心 单	忄 单
憝	敦 心
愤	心 贲	忄 贲	心 十 艹 贝
憧	心 童	忄 童
憨	敢 心
憩	舌 自 心
悯	心 闵	忄 闵
憬	心 景	忄 景
怃	心 无	忄 无
宪	宀 先
忆	心 乙	忄 乙
憷	心 楚	忄 楚
憾	心 感	忄 感
懂	心 董	忄 董
恳	艮 心
懈	心 解	忄 解
懊	心 奥
懋	楙 心
怿	心 又 二 丨	忄 又 二 丨
怀	心 不	忄 不
怼	对 心
懑	满 心
懦	心 需	忄 需
恹	心 厌	忄 厌
惩	征 心
懵	心 瞢	忄 瞢
懒	心 赖	忄 赖
悬	县 心
忏	心 千	忄 千
惧	心 具	忄 具
慑	心 聂	忄 聂
懿	壹 恣
恋	亦 心
戆	立 早 攴 页 心	立 早 攵 页 心
戈	一 乁 丿 丶
戊	丿 戈
戌	戊 一
戍	戊 丶
戎	十 戈	一 十 戈
成	戊 ㇆
我	手 戈	扌 戈	才 戈
戒	廾 戈
戋	戈 一
戕	爿 戈
或	口 一 戈
戚	厂 上 小 戈	丿 上 小 戈
戛	一 自 戈
戟	十 早 戈
戡	甚 戈
戢	口 耳 戈
戥	星 戈
战	占 戈
戗	仓 戈
戬	晋 戈
截	十 戈 隹	土 戈 隹	𢦏 隹
戮	翏 戈
戏	又 戈
戳	翟 戈	羽 隹 戈
戴	十 戈 異	土 戈 異	𢦏 異
户	丶 尸
戽	户 斗
戾	户 大
房	戶 方	户 方	戸 方
所	戶 斤	户 斤	戸 斤
扁	戶 冊	户 冊	戸 冊
扃	户 冋
扅	户 多
扇	戶 羽	户 羽	戸 羽
扈	戶 邑	户 邑	戸 邑
扉	户 非
扊	户 炎
手	丿 二 亅
才	一 亅 丿
扎	手 乚	扌 乚	才 乚
扒	手 八	扌 八	才 八
打	手 丁	扌 丁	才 丁
扔	手 乃	扌 乃	才 乃
拂	手 弗	扌 弗	才 弗
托	手 乇	扌 乇	才 乇
扛	手 工	扌 工	才 工
扣	手 口	扌 口	才 口
扦	手 千	扌 千	才 千
扭	手 丑	扌 丑	才 丑
扮	手 分	扌 分
扯	手 止	扌 止	才 止
扳	手 反	扌 反
扶	手 夫	扌 夫	才 夫
批	手 比	扌 比	才 比
扺	手 氏	扌 氏	才 氏
扼	手 厄	扌 厄	才 厄
找	手 戈	扌 戈	才 戈
承	氶 三
技	手 支	扌 支	才 支
抃	手 卞	扌 卞	才 卞
抄	手 少	扌 少	才 少
抉	手 夬	扌 夬	才 夬
把	手 巴	扌 巴
抑	手 卬	扌 卬	才 卬
抒	手 予	扌 予	才 予
抓	手 爪	扌 爪	才 爪
抔	手 不	扌 不	才 不
投	手 殳	扌 殳	才 殳
抖	手 斗	扌 斗	才 斗
抗	手 亢	扌 亢	才 亢
折	手 斤	扌 斤	才 斤
择	手 又 二 丨	扌 又 二 丨	才 又 二 丨
抨	手 平	扌 平	才 平
披	手 皮	扌 皮	才 皮
抬	手 台	扌 台	才 台
抱	手 包	扌 包
抵	手 氐	扌 氐	才 氐	手 氏 丶
抹	手 末	扌 末	才 末
抻	手 申	扌 申	才 申
押	手 甲	扌 甲	才 甲
抽	手 由	扌 由	才 由
抿	手 民	扌 民	才 民
拃	手 乍	扌 乍	才 乍
拄	手 主	扌 主	才 主
拆	手 斥	扌 斥	才 斥
拇	手 母	扌 母	才 母
拈	手 占	扌 占	才 占
拉	手 立	扌 立	才 立
拊	手 付	扌 付	才 付
抛	手 尢 力 拋	扌 尢 力 拋	才 尢 力 拋
拌	手 半	扌 半
拍	手 白	扌 白	才 白
拎	手 令	扌 令	才 令
拐	手 口 刀	扌 口 刀	才 口 刀	手 另
拒	手 巨	扌 巨	才 巨
拓	手 石	扌 石	才 石
拔	手 犮	扌 犮	才 犮
拖	手 丿 一 也	扌 丿 一 也	才 丿 一 也
拗	手 幼	扌 幼	才 幼
拘	手 句	扌 句	才 句
拙	手 出	扌 出	才 出
拚	手 厶 廾	扌 厶 廾	才 厶 廾
招	手 召	扌 召	才 召
拜	手 手
扩	手 广	扌 广	才 广
括	手 舌	扌 舌	才 舌
拭	手 式	扌 式	才 式
拮	手 吉	扌 吉	才 吉
拯	手 丞	扌 丞	才 丞
拱	手 共	扌 共	才 共
拳	丷 夫 手	𠔉 手
拴	手 全	扌 全	才 全
拶	手 巛 夕	扌 巛 夕	才 巛 夕
拷	手 考	扌 考	才 考
拼	手 并	扌 并	才 并
拽	手 曳	扌 曳	才 曳
拾	手 合	扌 合	才 合
拿	合 手
持	手 寺	扌 寺	才 寺
指	手 旨	扌 旨	才 旨
挈	丰 刀 手
按	手 安	扌 安	才 安
挎	手 夸	扌 夸	才 夸
挑	手 兆	扌 兆	才 兆
挖	手 穵	扌 穵	才 穵	手 穴 乙
挨	手 矣	扌 矣	才 矣
挪	手 那	扌 那	才 那
挫	手 坐	扌 坐	才 坐
振	手 辰	扌 辰	才 辰
挲	沙 手
挹	手 邑	扌 邑	才 邑
挺	手 廷	扌 廷	才 廷
挽	手 免	扌 免	才 免
挟	手 夹	扌 夹	才 夹
捃	手 君	扌 君	才 君
捅	手 甬	扌 甬	才 甬
捆	手 困	扌 困	才 困
捉	手 足	扌 足	才 足
捋	手 寽	扌 寽	才 寽	手 爪 寸	扌 爫 寸
捌	手 別	扌 別	才 別
捍	手 旱	扌 旱	才 旱
捎	手 肖	扌 肖	才 肖
捏	手 圼	扌 圼	才 圼
捐	手 肙	扌 肙	才 肙	手 口 月
捕	手 甫	扌 甫	才 甫
捧	手 奉	扌 奉	才 奉
舍	人 舌
捩	手 戾	扌 戾	才 戾	手 戶 犬	手 户 犬
扪	手 门	扌 门
捭	手 卑	扌 卑	才 卑
据	手 居	扌 居	才 居
捯	手 到	扌 到	才 到
捶	手 垂	扌 垂	才 垂
捷	手 疌	扌 疌	才 疌
捺	手 奈	扌 奈	才 奈
捻	手 念	扌 念	才 念
掀	手 欣	扌 欣	才 欣
掂	手 店	扌 店	才 店
扫	手 彐	扌 彐	才 彐
抡	手 仑	扌 仑	才 仑
掇	手 叕	扌 叕	才 叕
授	手 受	扌 受	才 受
掉	手 卓	扌 卓	才 卓
掊	手 咅	扌 咅	才 咅
掌	尚 口 手
掎	手 奇	扌 奇	才 奇
掏	手 匋	扌 匋	才 匋
掐	手 臽	扌 臽	才 臽
排	手 非	扌 非	才 非
掖	手 夜	扌 夜	才 夜
掘	手 屈	扌 屈	才 屈
挣	手 争	扌 争	才 争
挂	手 圭	扌 圭	才 圭
掠	手 京	扌 京	才 京
采	爪 木	爫 木
探	手 罙	扌 罙	才 罙
掣	制 手
接	手 妾	扌 妾	才 妾
控	手 空	扌 空	才 空
推	手 隹	扌 隹	才 隹
掩	手 奄	扌 奄	才 奄
措	手 昔	扌 昔	才 昔
掬	手 匊	扌 匊	才 匊	手 勹 米
掭	手 忝	扌 忝	才 忝
掮	手 肩	扌 肩	才 肩
掰	手 分 手
掾	手 彖	扌 彖	才 彖
拣	手 东 一	扌 东 一	才 东 一
揄	手 俞	扌 俞	才 俞
揆	手 癸	扌 癸	才 癸
揉	手 柔	扌 柔	才 柔
揍	手 奏	扌 奏	才 奏
揎	手 宣	扌 宣	才 宣
描	手 苗	扌 苗	才 苗
提	手 是	扌 是	才 是
插	手 臿	扌 臿	才 臿	手 千 臼
揖	手 咠	扌 咠	才 咠	手 口 耳
扬	手 弓 丿 丿	扌 弓 丿 丿	才 弓 丿 丿
换	手 奂	扌 奂	才 奂
揞	手 音	扌 音	才 音
揠	手 匽	扌 匽	才 匽
握	手 屋	扌 屋	才 屋
揣	手 耑	扌 耑	才 耑
揩	手 皆	扌 皆	才 皆
揪	手 秋	扌 秋	才 秋
揭	手 曷	扌 曷	才 曷
挥	手 军	扌 军	才 军
揳	手 契	扌 契	才 契
援	手 爰	扌 爰	才 爰
揶	手 耶	扌 耶	才 耶
揸	手 查	扌 查	才 查
背	北 肉	北 月
搋	手 虒	扌 虒	才 虒
搌	手 展	扌 展	才 展
损	手 员	扌 员	才 员
搏	手 尃	扌 尃	才 尃	手 甫 寸
搐	手 畜	扌 畜	才 畜
搒	手 旁	扌 旁	才 旁
搓	手 差	扌 差	才 差
搔	手 蚤	扌 蚤	才 蚤
摇	手 爪 缶	扌 爫 缶	才 爫 缶
捣	手 岛	扌 岛	才 岛
搛	手 兼	扌 兼	才 兼
搜	手 叟	扌 叟	才 叟
搞	手 高	扌 高	才 高
搠	手 朔	扌 朔	才 朔
搡	手 桑	扌 桑	才 桑
搦	手 弱	扌 弱	才 弱
搪	手 唐	扌 唐	才 唐
搬	手 般	扌 般	才 般
搭	手 荅	扌 荅	才 荅
搴	宀 井 大 手
揾	手 昷 搵	扌 昷 搵	才 昷 搵
抢	手 仓	扌 仓	才 仓
搽	手 茶	扌 茶	才 茶
捂	手 吾	扌 吾	才 吾
摁	手 恩	扌 恩	才 恩
摄	手 聂	扌 聂
掴	手 国	扌 国	才 国
摒	手 屏	扌 屏	才 屏
摔	手 率	扌 率	才 率
摘	手 啇	扌 啇	才 啇
掼	手 贯	扌 贯	才 贯
摞	手 累	扌 累	才 累
搂	手 娄	扌 娄	才 娄
摧	手 崔	扌 崔	才 崔
摩	麻 手
摭	手 庶	扌 庶	才 庶
挚	执 手
抠	手 区	扌 区	才 区
抟	手 专	扌 专
摸	手 莫	扌 莫	才 莫
摹	莫 手
掺	手 参	扌 参	才 参
摽	手 票	扌 票	才 票
撂	手 畧	扌 畧	才 畧	手 田 各
撅	手 厥	扌 厥	才 厥
撇	手 敝	扌 敝	才 敝
捞	手 劳	扌 劳	才 劳
挦	手 寻	扌 寻
撑	手 掌	扌 掌	才 掌	手 尚 手
撒	手 散	扌 散	才 散
挠	手 尧	扌 尧	才 尧
撕	手 斯	扌 斯	才 斯
撖	手 敢	扌 敢	才 敢
撙	手 尊	扌 尊	才 尊
撞	手 童	扌 童	才 童
挢	手 乔	扌 乔	才 乔
掸	手 单	扌 单
撤	手 育 攵	扌 育 攵	才 育 攵
拨	手 发	扌 发	才 发
撩	手 尞	扌 尞	才 尞
抚	手 无	扌 无	才 无
撬	手 毳	扌 毳	才 毳
播	手 番	扌 番	才 番
撮	手 最	扌 最	才 最
撰	手 巽	扌 巽	才 巽
扑	手 卜	扌 卜	才 卜
揿	手 钦	扌 钦	才 钦
搅	手 觉	扌 觉
挞	手 达	扌 达	才 达
撼	手 感	扌 感	才 感
挝	手 过	扌 过	才 过
捡	手 佥	扌 佥	才 佥
擀	手 幹	扌 幹	才 幹
拥	手 用	扌 用	才 用
擂	手 雷	扌 雷	才 雷
掳	手 虏	扌 虏	才 虏
擅	手 亶	扌 亶	才 亶
击	二 山
挡	手 当	扌 当	才 当
操	手 品 木	扌 品 木	才 品 木	扌 喿
擎	敬 手
擐	手 睘	扌 睘	才 睘
擒	手 禽	扌 禽	才 禽
担	手 旦	扌 旦	才 旦
携	手 隽	扌 隽
擘	辟 手
挤	手 齐	扌 齐	才 齐
擢	手 翟	扌 翟	才 翟
擤	手 鼻	扌 鼻	才 鼻
擦	手 察	扌 察	才 察
拟	手 以	扌 以	才 以
摈	手 宾	扌 宾	才 宾
拧	手 宁	扌 宁	才 宁
搁	手 阁	扌 阁	才 阁
掷	手 掷 郑	扌 掷 郑	才 掷 郑
撷	手 颉	扌 颉	才 颉
摆	手 罢	扌 罢	才 罢
擞	手 数	扌 数	才 数
撸	手 鲁	扌 鲁
扰	手 尤	扌 尤	才 尤
攀	棥 大 手	林 爻 大 手	木 木 乂 乂 大 手
摅	手 虑	扌 虑
撵	手 辇	扌 辇	才 辇
攉	手 霍	扌 霍	才 霍
拢	手 龙	扌 龙	才 龙
拦	手 兰	扌 兰	才 兰
撄	手 婴	扌 婴
攘	手 襄	扌 襄	才 襄
搀	手 免 冫	扌 免 冫	才 免 冫
撺	手 窜	扌 窜	才 窜
攒	手 赞	扌 赞	才 赞
挛	亦 手
摊	手 难	扌 难	才 难
攥	手 纂	扌 纂	才 纂
攫	手 瞿	扌 瞿	才 瞿
揽	手 览	扌 览	才 览
攮	手 囊	扌 囊	才 囊
支	十 又
收	丩 攴	丩 攵
攸	人 丨 攴	亻 丨 攵
改	己 攴	己 攵
攻	工 攴	工 攵
放	方 攴	方 攵
政	正 攴	正 攵
故	古 攴	古 攵
效	交 攴	交 攵
敉	米 攴	米 攵
教	孝 攴	孝 攵
敏	每 攴	每 攵
救	求 攴	求 攵
敕	束 攴	束 攵
敖	土 方 攴	土 方 攵
败	贝 攴	贝 攵
叙	余 又
敝	丷 巾 八 攴	丷 巾 八 攵	㡀 攴	㡀 攵
敞	尚 攴	尚 攵
敢	丅 耳 攴	丅 耳 攵
散	井 月 攴	井 月 攵
敦	享 攴	享 攵
敫	白 方 攴	白 方 攵
敬	茍 攴	茍 攵
敲	高 攴	高 攵
整	敕 正	束 攵 正
敌	舌 攴	舌 攵
敷	旉 攴	旉 攵	甫 方 攴
数	娄 攴	娄 攵
敛	佥 攴	佥 攵
毙	比 死
文	亠 乂
齐	文 丿 丨
斌	文 武
斋	文 而
斐	非 文
斑	王 文 王	玉 文 王
斓	文 阑
斗	丶 丶 一 丨
料	米 斗
斛	角 斗
斜	余 斗
斝	口 口 冖 斗
斟	甚 斗
斡	十 日 十 人 斗
斤	厂 丅
斥	斤 丶
斧	父 斤
斫	石 斤
斩	车 斤
斯	其 斤
新	亲 斤	立 木 斤
断	丨 一 米 斤
方	亠 勹	亠 刀
施	方 丿 一 也
旁	亠 丷 冖 方
旃	方 丿 一 円
旄	方 丿 一 毛
旅	方 丿 一 氏
旆	方 丿 一 巿
旋	方 丿 一 疋
旌	方 丿 一 生
旎	方 丿 一 尼
族	方 丿 一 矢
旒	方 丿 一 亠 厶 川	方 丿 一 巟	方 丿 一 㐬
旖	方 丿 一 奇
旗	方 丿 一 其
既	艮 旡
日	口 一	口 丶
旦	日 一
旨	匕 日
早	日 十
旬	勹 日
旭	九 日
旮	九 日
旯	日 九
旰	日 干
旱	日 干
旺	日 王
旻	日 文
昀	日 勻	日 匀
昂	日 卬
昃	日 仄
昉	日 方
昊	日 天
昌	日 曰	日 日
明	日 月
昏	氏 日
易	日 勿
昔	井 日
昕	日 斤
昝	处 日
星	生 日
映	日 央
春	手 乀 日	龹 日
昧	日 未
昨	日 乍
昭	日 召
是	日 疋	曰 疋
昱	日 立
昴	日 卯
昶	永 日
旷	日 广
晁	日 兆
时	日 寸
晃	日 光
晋	亚 日
晌	日 向
晏	日 安
晗	日 含
晚	日 免
昼	尺 旦
晞	日 希
晟	日 成
晡	日 甫
晤	日 吾
晦	日 每
晨	日 辰
普	並 日	丷 晋
景	日 京
晰	日 析
晳	析 日
晴	日 青
晶	日 日 日
晷	日 咎
智	知 日
晾	日 京
晓	日 尧
暄	日 宣
暅	日 恒
暇	日 叚
晕	日 军
晖	日 军
暌	日 癸
暑	日 者
暖	日 爰
暗	日 音
旸	日 弓 丿 丿
暝	日 冥
畅	申 弓 丿 丿
暨	既 旦
暂	斩 日
暮	莫 日
昵	日 尼
暴	日 共 水	日 恭
暹	日 進
暾	日 敦
晔	日 华
历	厂 力
昙	日 云
曈	日 童
暧	日 爱
曙	日 署
曛	日 熏
曜	日 翟
曝	日 暴
曦	日 羲
昽	日 龙
曩	日 囊
晒	日 西
曰	曰 丶	曰 一
曲	囗 卄	曰 丨 丨
曳	曰 乁 丿
更	一 日 人	一 曰 人	一 田 人	一 申 人
曷	日 勹 丨 一 人
书	㇆ ㇆ 丨 丶
曹	卄 曰 日	一 丨 丨 曰 日
曼	曰 目 又
曾	丷 口 丨 丷 曰	八 口 丨 丷 曰
替	夫 夫 曰	夫 夫 日
最	曰 取	日 取
会	人 云
月	冂 一 一
有	一 丿 月
朊	月 元
朋	月 月
服	月 卩 又
朐	月 句
朔	屰 月
朕	肉 关	月 关
朗	良 月
朘	月 夋
望	亡 月 王
朝	十 日 十 月	卓 月	車 月
期	其 月
朦	月 蒙
胧	月 龙
木	十 人	十 八	一 小
未	一 木
末	木 一
本	木 一
札	木 乚
朱	丿 未	丶 未	丿 一 木 未
朴	木 卜
朵	几 木
朽	木 丂
杆	木 干
杈	木 叉
杉	木 彡
杌	木 兀
李	木 子
杏	木 口
材	木 才
村	木 寸
杓	木 勺
杖	木 丈
杜	木 土
杞	木 己
束	木 口
杠	木 工
杧	木 亡
杪	木 少
杭	木 亢
杯	木 不
东	一 𠃋 小
杲	日 木
杳	木 日
杵	木 午
杷	木 巴
杻	木 丑
杼	木 予
松	木 公
板	木 反
枇	木 比
枉	木 王
枋	木 方
析	木 斤
枕	木 冘
林	木 木
枘	木 内
枚	木 攴	木 攵
果	日 木
枝	木 支
枯	木 古
枰	木 平
枳	木 只
枵	木 号
架	加 木
枷	木 加
枸	木 句
柁	木 它
柃	木 令
柄	木 丙
柈	木 半
柏	木 白
某	甘 木
柑	木 甘
柒	氵 七 木
染	水 九 木	氵 九 木	氿 木
柔	矛 木
柘	木 石
柙	木 甲
柚	木 由
柝	木 拆
柞	木 乍
柢	木 氐
查	木 旦
柩	木 久
柬	木 口 丷	木 囗 丷
柯	木 可
柰	木 示
柱	木 主
柳	木 卯
柴	此 木
栅	木 册
柿	木 市
栀	木 卮
荣	草 冖 木	艸 冖 木	艹 冖 木
栒	木 旬
栓	木 全
栝	木 舌
栟	木 并
校	木 交
栩	木 羽
株	木 朱
栲	木 考
栳	木 老
核	木 亥
根	木 艮
格	木 各
栽	十 戈 木	土 戈 木	𢦏 木
桀	舛 木
桁	木 行
桂	木 圭
桃	木 兆
桄	木 光
桅	木 危
框	木 匡
案	安 木
桉	木 安
桊	丷 夫 木	𠔉 木
桌	木 卜 日
桎	木 至
桐	木 同
桑	木 叒	木 又 又 又
桓	木 亘
桔	木 吉
桕	木 臼
樱	木 婴
栈	木 戋
桫	木 沙
桴	木 孚
桶	木 甬
桷	木 角
梁	水 刅 木	氵 刅 木
梃	木 廷
梅	木 每
梆	木 邦
梏	木 告	木 牛 口
梓	木 辛
梗	木 更
枧	木 见
条	夕 木	夂 木
枭	鸟 木
梢	木 肖
梧	木 吾
梨	利 木
梭	木 夋
梯	木 弟
械	木 戒
棁	木 兑
梳	木 亠 厶 川	木 巟	木 㐬
梵	木 木 凡
梽	木 志
弃	亠 厶 廾
棉	木 帛
棋	木 其
棍	木 昆
棒	木 奉
棕	木 宗
枨	木 长
枣	朿 冰	朿 冫
棘	朿 朿
棚	木 朋
栋	木 东
棠	尚 木
棣	木 隶
棬	木 卷
森	木 木 木	木 林
棰	木 垂
棱	木 夌
栖	木 西
棵	木 果
梾	木 来
棹	木 卓
棺	木 官
棻	芬 木
棼	林 分
椁	木 享
椅	木 奇
椋	木 京
植	木 直
椎	木 隹
椐	木 居
椑	木 卑
椒	木 叔
检	木 佥
椰	木 耶
椴	木 段
椽	木 彖
椿	木 春
楂	木 查
杨	木 弓 丿 丿
枫	木 风
楔	木 契
楗	木 建
楚	林 疋
楝	木 柬
楠	木 南
楣	木 眉
楦	木 宣
桢	木 贞
楫	木 咠	木 口 耳
业	丨 丨 丷 一
楮	木 者
楯	木 盾
极	木 及
楷	木 皆
楸	木 秋
楹	木 盈
乐	丿 丨 木	丿 丨 朩
榀	木 品
概	木 既
榆	木 俞
榍	木 屑
榔	木 郎
榕	木 容
榖	士 冖 一 木 殳
榛	木 秦
榜	木 旁
榧	木 匪
榨	木 窄
榫	木 隼	木 隹 十
榭	木 射
榴	木 留
榷	木 隺
榻	木 日 羽	木 曰 羽
桤	木 岂
槁	木 高
槊	木 朔
构	木 勾
槌	木 追
枪	木 仓
槎	木 差
槐	木 鬼
槔	木 皋
样	木 羊
槜	木 隽
椠	木 斩
槭	木 戚
槲	木 斛
桨	丬 夕 木
槽	木 曹
槿	木 堇
桩	木 庄
枞	木 从
樊	棥 大
楼	木 娄
樗	木 雩
樘	木 堂
标	木 示
枢	木 区
樟	木 章
模	木 莫
樨	木 犀
权	木 又
樵	木 焦
树	木 又 寸
桦	木 华
樽	木 尊
樾	木 越
橄	木 敢
橇	木 毳
桡	木 尧
桥	木 乔
橐	一 中 冖 木 石
橘	木 矞
橙	木 登
橛	木 厥
机	木 几
橡	木 象
椭	木 隋 橢
橦	木 童
横	木 黄
檀	木 亶
檩	木 禀
檄	木 敫
柽	木 圣
檎	木 禽
檑	木 雷
档	木 当
檗	辟 木
桧	木 会
槚	木 贾
檠	敬 木
樯	木 啬
檫	木 察
檬	木 蒙
槟	木 宾
檵	木 丨 一 幺 幺 一 幺 幺
柠	木 宁
槛	木 监
柜	木 巨
橱	木 厨
橹	木 鲁
榈	木 闾	木 门 吕
栉	木 节
椟	木 卖
橼	木 缘
栎	木 乐
槠	木 诸
栌	木 卢
枥	木 历
橥	木 猪
榇	木 亲
栊	木 龙
榉	木 举
栏	木 兰
椤	木 罗
栾	亦 木
榄	木 览
棂	木 灵
欠	刀 人
次	冫 欠	冰 欠
欣	斤 欠
欸	矣 欠
欺	其 欠
钦	金 欠	钅 欠
款	士 示 欠
歃	臿 欠
歆	音 欠
歇	曷 欠
歉	兼 欠
歌	哥 欠
欧	区 欠
欢	又 欠
歙	翕 欠
欤	与 欠
止	上 丨
正	一 止
此	止 匕
步	止 小	止 亅 丶 丿	止 少
武	一 弋 止
歧	止 支
歪	不 正
齿	止 人 凵
岁	山 夕
归	丨 丿 彐
歹	一 夕
死	歹 匕	一 夕 匕
殁	歹 殳
殂	歹 且
殃	歹 央
殄	歹 人 彡
殆	歹 台
殉	歹 旬
殊	歹 朱
殍	歹 孚
殖	歹 直
残	歹 戋
殛	歹 亟
殒	歹 员
殣	歹 堇
殇	歹 丿 一 弓 丿 丿
殪	歹 壹
殚	歹 单
殓	歹 佥
殡	歹 宾
歼	歹 千
殳	几 又
段	丿 丰 殳
殷	丶 丿 彐 ㇆ 殳	㐆 殳
杀	乂 一 小	乂 木
壳	士 冗
殿	尸 共 殳
毁	臼 工 殳
毅	豙 殳	立 豕 殳
殴	区 殳
母	丨 一 二 丶 丶 亅
每	丿 一 母
毐	士 母
毒	丰 毋	丰 母
毓	每 亠 厶 川	每 巟	每 㐬
比	匕 匕
毖	比 必
毗	田 比
毛	丿 一 匕
毪	毛 牟
毫	亠 口 冂 毛
毯	毛 炎
毳	毛 毛 毛
毹	俞 毛
毽	毛 建
毵	参 毛
牦	牛 毛	牜 毛
氅	敞 毛
氆	毛 普
毡	毛 占
氇	毛 鲁
氍	瞿 毛
氐	氏 丶
氓	亡 民
氕	气 丿
氖	气 乃
气	乞 一	丿 一 一 乙
氘	气 丿 丨
氙	气 山
氚	气 川
氛	气 分
氟	气 弗
氡	气 冬
氤	气 因
氦	气 亥
氧	气 羊
氨	气 安
氪	气 克
氢	气 圣
氩	气 亚
氮	气 炎
氯	气 录
氰	气 青
氲	气 昷
水	乛 亅 丶 乀
永	丶 一 水
氽	人 水
汀	水 丁	氵 丁
汁	水 十	氵 十
求	水 一 丶
汆	入 水
汈	水 刁	氵 刁
汊	水 叉	氵 叉
汐	水 夕	氵 夕
汔	水 乞	氵 乞
汕	水 山	氵 山
汗	水 干	氵 干
污	水 亏	氵 亏
汛	水 卂	氵 卂
汜	水 巳	氵 巳
汝	水 女	氵 女
汞	工 水
江	水 工	氵 工
池	水 也	氵 也
汨	水 曰	氵 日
汩	水 日	氵 日
汪	水 王	氵 王
汭	水 内		氵 内
汰	水 太	氵 太
汲	水 及	氵 及
汴	水 卞	氵 卞
汶	水 文	氵 文
决	冰 夬	冫 夬
汽	水 氣	氵 气
汾	水 分	氵 分
沁	水 心	氵 心
沂	水 斤	氵 斤
沃	水 夭	氵 夭
沅	水 元	氵 元
沆	水 亢	氵 亢
沈	水 冘	氵 冘
沌	水 屯	氵 屯
沏	水 切	氵 切
沐	水 木	氵 木
没	水 殳	氵 殳
沓	水 日	氵 日
沔	水 丏	氵 丏
冲	冫 中	冰 中
沘	水 比	氵 比
沙	水 少	氵 少
沚	水 止	氵 止
沛	水 巿	氵 巿
泽	水 又 二 丨	氵 又 二 丨
沣	水 丰	氵 丰
沫	水 末	氵 末
沭	水 朮	氵 朮
沮	水 且	氵 且
沱	水 它	氵 它
河	水 可	氵 可
沸	水 弗	氵 弗
油	水 由	氵 由
治	水 台	氵 台
沼	水 召	氵 召
沽	水 古	氵 古
沾	水 占	氵 占
沿	水 八 口	氵 八 口
况	冰 兄	冫 兄
泃	水 句	氵 句
泄	水 世	氵 世
泅	水 囚	氵 囚
泉	白 水
泊	水 白	氵 白
泌	水 必	氵 必
泐	水 阞	氵 阞
泓	水 弘	氵 弘
泔	水 甘	氵 甘
法	水 去	氵 去
泖	水 卯	氵 卯
泗	水 四	氵 四
泚	水 此	氵 此
泛	水 乏	氵 乏
泜	水 氐	氵 氐
泠	水 令	氵 令
泡	水 包	氵 包
波	水 皮	氵 皮
泣	水 立	氵 立
泥	水 尼	氵 尼
注	水 主	氵 主
泫	水 玄	氵 玄
泮	水 半	氵 半
泯	水 民	氵 民
泰	手 乀 水	龹 水
泱	水 央	氵 央
泳	水 永	氵 永
泵	石 水
洄	水 回	氵 回
洇	水 因	氵 因
洋	水 羊	氵 羊
洌	水 列	氵 列
洎	水 自	氵 自
洑	水 伏	氵 伏
洗	水 先	氵 先
洙	水 朱	氵 朱
洚	水 夅	氵 夅
洛	水 各	氵 各
洞	水 同	氵 同
洣	水 米	氵 米
津	水 聿	氵 聿
洧	水 有	氵 有
洨	水 交	氵 交
洪	水 共	氵 共
洫	水 血	氵 血
洮	水 兆	氵 兆
洱	水 耳	氵 耳
洲	水 州	氵 州
洳	水 如	氵 如
洴	水 并	氵 并
洵	水 旬	氵 旬
汹	水 凶	氵 凶
洹	水 亘	氵 亘
洺	水 名	氵 名
活	水 舌	氵 舌
洽	水 合	氵 合
派	水 厂 氏	氵 厂 氏	水 𠂢	氵 𠂢
流	水 亠 厶 川	氵 亠 厶 川	氵 巟	水 㐬	氵 㐬
浙	水 折	氵 折
浚	水 夋	氵 夋
浜	水 兵	氵 兵
浞	水 足	氵 足
浠	水 希	氵 希
浡	水 孛	氵 孛
浣	水 完	氵 完
浥	水 邑	氵 邑
浦	水 甫	氵 甫
浩	水 告	氵 告
浪	水 良	氵 良
浮	水 孚	氵 孚
浯	水 吾	氵 吾
浴	水 谷	氵 谷
海	水 每	氵 每
浸	水 彐 冖 又	氵 彐 冖 又
浃	水 夹	氵 夹
浼	水 免	氵 免
涅	水 圼	氵 圼
泾	水 圣	氵 圣
消	水 肖	氵 肖
涉	水 步	氵 步
涎	水 延	氵 延
涑	水 束	氵 束
涓	水 肙	氵 肙
涔	水 岑	氵 岑
涕	水 弟	氵 弟
涘	水 矣	氵 矣
渎	水 卖	氵 卖
涪	水 咅	氵 咅
涫	水 官	氵 官
涮	水 刷	氵 刷
涯	水 厓	氵 厓
液	水 夜	氵 夜
涵	水 函	氵 函
涸	水 固	氵 固
凉	冰 京	冫 京
涿	水 豖	氵 豖
淄	水 甾	氵 甾
淅	水 析	氵 析
淆	水 肴	氵 肴
淇	水 其	氵 其
淋	水 林	氵 林
淌	水 尚	氵 尚
淏	水 昊	氵 昊
淑	水 叔	氵 叔
凄	冰 妻	冫 妻
淖	水 卓	氵 卓
淘	水 匋	氵 匋
泪	水 目	氵 目
淝	水 肥	氵 肥
淞	水 松	氵 松
淠	水 畀	氵 畀
淡	水 炎	氵 炎
淤	水 於	氵 於
渌	水 录	氵 录
淦	水 金	氵 金
沦	水 仑	氵 仑
淫	水 爪 壬	氵 爫 壬
淬	水 卒	氵 卒
淮	水 隹	氵 隹
深	水 罙	氵 罙
淳	水 享	氵 享
渊	水 丿 米 丨	氵 片 一 爿
涞	水 来	氵 来
混	水 昆	氵 昆
清	水 青	氵 青
淹	水 奄	氵 奄
浅	水 戋	氵 戋
添	水 忝	氵 忝
济	水 齐	氵 齐
涣	水 奂	氵 奂
渚	水 者	氵 者
减	冰 咸	冫 咸
渝	水 俞	氵 俞
渠	洰 木
渡	水 度	氵 度
沨	水 风	氵 风
渣	水 查	氵 查
渤	水 勃	氵 勃
渥	水 屋	氵 屋
涡	水 呙	氵 呙
渫	水 枼	氵 枼
测	水 则	氵 则
渭	水 胃	氵 胃
港	水 巷	氵 巷
渲	水 宣	氵 宣
渴	水 曷	氵 曷
游	水 斿	氵 斿
渺	水 目 少	氵 目 少
浑	水 军	氵 军
湃	水 拜	氵 拜
湄	水 眉	氵 眉
湉	水 恬	氵 恬
凑	冰 奏	冫 奏
湍	水 耑	氵 耑	水 山 而	氵 山 而
湎	水 面	氵 面
湔	水 前	氵 前
湖	水 胡	氵 胡
湘	水 相	氵 相
湛	水 甚	氵 甚
湜	水 是	氵 是
湝	水 皆	氵 皆
浈	水 贞	氵 贞
湟	水 皇	氵 皇
涌	水 甬	氵 甬
湨	水 狊	氵 狊
湫	水 秋	氵 秋
湮	水 垔	氵 垔
汤	水 弓 丿 丿	氵 弓 丿 丿
湲	水 爰	氵 爰
满	水 草 两	氵 艸 两	艹 两
溆	水 叙	氵 叙
沩	水 为	氵 为
溉	水 既	氵 既
泼	水 发	氵 发
溏	水 唐	氵 唐
源	水 原	氵 原
溘	水 盍	氵 盍
溜	水 留	氵 留
沟	水 勾	氵 勾
溟	水 冥	氵 冥
溠	水 差	氵 差
溢	水 益	氵 益
溥	水 尃	氵 尃
溦	水 山 兀 攴	氵 山 兀 攵
溧	水 栗	氵 栗
溪	水 奚	氵 奚
温	水 昷	氵 昷
浉	水 师	氵 师
溯	水 朔	氵 朔
溱	水 秦	氵 秦
溲	水 叟	氵 叟
涢	水 员	氵 员
溴	水 臭	氵 臭
溶	水 容	氵 容
溷	水 圂	氵 圂
溺	水 弱	氵 弱
溻	水 日 羽	氵 日 羽
湿	水 显	氵 显
溽	水 辱	氵 辱
滁	水 除	氵 除
滂	水 旁	氵 旁
滃	水 翁	氵 翁
沧	水 仓	氵 仓
灭	一 火
滇	水 真	氵 真
滋	水 兹	氵 兹
涤	水 条	氵 条
滍	水 蚩	氵 蚩
荥	草 冖 水	艸 冖 水	艹 冖 水
滏	水 釜	氵 釜
滑	水 骨	氵 骨
滓	水 宰	氵 宰
滔	水 舀	氵 舀
滕	水 丷 夫 水	氵 丷 夫 水	水 𠔉 水	氵 𠔉 水
滘	水 冖 八 工 口	氵 冖 八 工 口	水 㓁 工 口	氵 㓁 工 口
泷	水 龙	氵 龙
滫	水 脩	氵 脩
沪	水 户	氵 户
滞	水 带	氵 带
渗	水 参	氵 参
滴	水 啇	氵 啇
卤	卜 囗 乂
浒	水 许	氵 许
滹	水 虖	氵 虖
浐	水 产	氵 产
滚	水 衮	氵 衮
渔	水 鱼	氵 鱼
漂	水 票	氵 票
漆	水 桼	氵 桼
漉	水 鹿	氵 鹿
溇	水 娄	氵 娄
漏	水 屚	氵 屚
漓	水 离	氵 离
演	水 寅	氵 寅
漕	水 曹	氵 曹
沤	水 区	氵 区
漠	水 莫	氵 莫
汉	水 又	氵 又
涟	水 连	氵 连
漤	水 婪	氵 婪
漩	水 旋	氵 旋
漪	水 犬 奇	氵 犭 奇
漫	水 曼	氵 曼
渍	水 责	氵 责
漭	水 莽	氵 莽
漯	水 累	氵 累
漱	水 欶	氵 欶
涨	水 张	氵 张
漳	水 章	氵 章
漶	水 患	氵 患
渐	水 斩	氵 斩
漾	水 羕	氵 羕
浆	丬 夕 水
颍	匕 水 页
灌	水 雚	氵 雚
潏	水 矞	氵 矞
洁	水 吉	氵 吉
潘	水 番	氵 番
潜	水 替	氵 替
潞	水 路	氵 路
潟	水 臼 勹 火	氵 臼 勹 灬
潢	水 黄	氵 黄
润	水 闰	氵 闰
潦	水 尞	氵 尞
潭	水 覃	氵 覃
潮	水 朝	氵 朝
浔	水 寻	氵 寻
溃	水 贵	氵 贵
潲	水 稍	氵 稍
潵	水 散	氵 散
滗	水 笔	氵 笔
潸	水 木 木 月	氵 木 木 月
潺	水 孱	氵 孱
潼	水 童	氵 童
潽	水 普	氵 普
涠	水 围	氵 围
涩	水 刃 止	氵 刃 止
澄	水 登	氵 登
浇	水 尧	氵 尧
涝	水 劳	氵 劳
澈	水 育 攵	氵 育 攵
澉	水 敢	氵 敢
澌	水 斯	氵 斯
澍	水 尌	氵 尌
澎	水 彭	氵 彭
沄	水 云	氵 云
涧	水 间	氵 间
渑	水 黾	氵 黾
澡	水 品 木	氵 品 木	氵 喿
澥	水 解	氵 解
滪	水 预	氵 预
澧	水 豊	氵 豊
浍	水 会	氵 会
淀	水 定	氵 定
澳	水 奥	氵 奥
澴	水 睘	氵 睘
澶	水 亶	氵 亶
澹	水 詹	氵 詹
澼	水 辟	氵 辟
激	水 敫	氵 敫
浊	水 虫	氵 虫
濂	水 廉	氵 廉
浓	水 农 脓	氵 农 脓
濉	水 睢	氵 睢
泞	水 宁	氵 宁
蒙	草 冡	艸 冡	艹 冡
浕	水 尽	氵 尽
濞	水 鼻	氵 鼻
濠	水 豪	氵 豪
濡	水 需	氵 需
涛	水 寿	氵 寿
滥	水 监	氵 监
濯	水 翟	氵 翟
潍	水 维	氵 维
滨	水 宾	氵 宾
溅	水 贱	氵 贱
泺	水 乐	氵 乐
滤	水 虑	氵 虑
滢	水 莹	氵 莹
泻	水 写	氵 写
瀌	水 麃	氵 麃
瀍	水 廛	氵 廛
浏	水 文 刀	氵 文 刂
瀑	水 暴	氵 暴
濒	水 频	氵 频
泸	水 卢	氵 卢
瀚	水 翰	氵 翰
瀛	水 嬴	氵 嬴
沥	水 历	氵 历
潇	水 肃	氵 肃
潆	水 萦	氵 萦
瀣	水 韰	氵 韰
潴	水 猪	氵 猪
濑	水 赖	氵 赖
潋	水 敛	氵 敛
瀵	水 糞	氵 糞
瀹	水 龠	氵 龠
澜	水 阑	氵 阑
滠	水 聂	氵 聂
滟	水 艳	氵 艳
洒	水 西	氵 西
滩	水 难	氵 难
灏	水 颢	氵 颢
灞	水 霸	氵 霸
湾	水 弯	氵 弯
滦	水 栾	氵 栾
火	丷 人
灰	厂 火	一 丿 火
灶	火 土
灸	久 火
灼	火 勺
灾	宀 火
炅	日 火
炊	火 欠
炎	火 火
炒	火 少
炔	火 夬
炕	火 亢
炙	肉 火	月 火
炟	火 旦
炫	火 玄
炬	火 巨
炭	山 灰	山 厂 火
炮	火 包
炯	火 冋
炱	台 火
炳	火 丙
炷	火 主
炸	火 乍
为	丶 丿 ㇆ 丶
炻	火 石
烀	火 乎
烈	列 火	列 灬
烊	火 羊
乌	勹 ㇉ 一
烘	火 共
烙	火 各
烜	火 亘
烝	丞 火	丞 灬
烤	火 考
烯	火 希
烃	火 圣
烷	火 完
烹	亨 火	亨 灬
烺	火 良
烽	火 夆
焉	正 一 勹 火	正 一 勹 灬
焊	火 旱
焌	火 夋
焐	火 吾
焓	火 含
焰	火 臽
焙	火 咅
焚	林 火
焜	火 昆
无	一 尢
焦	隹 火	隹 灬
焯	火 卓
焱	火 火 火
然	肉 犬 火	月 犬 灬
烧	火 尧
煅	火 段
炼	火 东 一
煊	火 宣
煌	火 皇
煎	前 火	前 灬
炜	火 韦
烟	火 因
煜	火 日 立
煞	刍 攴 火	刍 攵 灬
茕	草 冖 卂	艸 冖 卂	艹 冖 卂
煤	火 某
焕	火 奂
煦	昫 火	昫 灬
照	日 召 火	日 召 灬
煨	火 畏
烦	火 页
炀	火 弓 丿 丿
煮	者 火	者 灬
煲	保 火
煳	火 胡
煸	火 扁
煺	火 退
煽	火 扇
熄	火 息
熊	能 火	能 灬
熏	丿 一 黑	丿 一 里 丷 火	丿 一 里 丷 灬
荧	草 冖 火	艸 冖 火	艹 冖 火
熔	火 容
炝	火 仓
熘	火 留
熙	巸 火	巸 灬
熜	火 悤
熟	孰 火	孰 灬
熠	火 習
熥	火 通
熨	尉 火
熬	敖 火
热	执 火	执 灬
熵	火 商
熹	喜 火	喜 灬
炽	火 只
烨	火 华
燃	火 然
灯	火 丁
炖	火 屯
燎	火 尞
燏	火 矞
燔	火 番
燕	廿 北 口 火	廿 北 口 灬
烫	汤 火
焖	火 闷
燥	火 品 木	火 喿
灿	火 山
燧	火 遂
烛	火 虫
燮	火 言 火 又
烩	火 会
燹	豕 豕 火
烬	火 尽
焘	寿 火	寿 灬
爆	火 暴
烁	火 乐
炉	火 户
烂	火 兰
爝	火 爵
爨	臼 同 冖 林 大 火
爪	厂 丨 乀
爬	爪 巴
争	刀 聿	爫 彐 亅 爭	刀 彐 亅	刀 肀
爰	爪 一 友	爫 一 友
爵	爪 聿 爭 爭	爫 肀 爭
父	八 乂
爸	父 巴
爹	父 多
爷	父 卩
爻	乂 乂
爽	大 爻 爻	大 乂 乂 乂 乂
尔	刀 小	丿 乛 亅 八
爿	丨 一 丨 一 丿
牁	爿 可
牂	爿 羊
片	丄 丿 ㇆
版	片 反
牌	片 卑
牒	片 枼
牖	片 戶 甫
牍	片 卖
牙	丅 一 亅 丿
牚	尚 牙
牛	丿 一 十
牝	牛 匕	牜 匕
牟	厶 牛
牡	牛 土	牜 土
牢	宀 牛
牧	牛 攴	牜 攵
物	牛 勿	牜 勿
牮	代 牛
牯	牛 古	牜 古
牲	牛 生	牜 生
特	牛 寺	牜 寺
牵	大 冖 牛
牾	牛 吾	牜 吾
犀	尸 二 丨 二 牛
犁	利 牛
犄	牛 奇	牜 奇
犋	牛 具	牜 具
犍	牛 建	牜 建
犏	牛 扁	牜 扁
犒	牛 高	牜 高
荦	草 冖 牛	艸 冖 牛	艹 冖 牛
犟	强 牛
犊	牛 卖	牜 卖
牺	牛 西	牜 西
犬	大 丶
犯	犬 卩	犭 卩	犬 㔾	犭 㔾
犰	犬 九	犭 九
犴	犬 干	犭 干
状	丬 犬
狁	犬 允	犭 允
狂	犬 王	犭 王
狃	犬 丑	犭 丑
狄	犬 火	犭 火
狉	犬 丕	犭 丕
狍	犬 包	犭 包
狎	犬 甲	犭 甲
狐	犬 瓜	犭 瓜
狒	犬 弗	犭 弗
狗	犬 句	犭 句
狙	犬 且	犭 且
狠	犬 艮	犭 艮
狡	犬 交	犭 交
狨	犬 戎	犭 戎
狩	犬 守	犭 守
狳	犬 余	犭 余
狴	犬 比 土	犭 比 土
狷	犬 肙	犭 肙
狸	犬 里	犭 里
狭	犬 夹	犭 夹
狺	犬 言	犭 言
狻	犬 夋	犭 夋
狼	犬 良	犭 良
狈	犬 贝	犭 贝
猁	犬 利	犭 利
猄	犬 京	犭 京
猊	犬 兒	犭 兒
猖	犬 昌	犭 昌
猗	犬 奇	犭 奇
狰	犬 争	犭 争
猛	犬 孟	犭 孟
猜	犬 青	犭 靑
猝	犬 卒	犭 卒
猞	犬 舍	犭 舍
猢	犬 胡	犭 胡
猥	犬 畏	犭 畏
猩	犬 星	犭 星
猱	犬 柔	犭 柔
猴	犬 侯	犭 侯
犹	犬 尤	犭 尤
猷	酋 犬
猸	犬 眉	犭 眉
猹	犬 查	犭 查
狲	犬 孙	犭 孙
猾	犬 骨	犭 骨
猿	犬 袁	犭 袁
犸	犬 马	犭 马
狱	犬 言 犬	犭 讠 犬
狮	犬 师	犭 师
獍	犬 竟	犭 竟
獐	犬 章	犭 章
獒	敖 犬
獗	犬 厥	犭 厥
獠	犬 尞	犭 尞
独	犬 虫	犭 虫
狯	犬 会	犭 会
猃	犬 佥	犭 佥
獬	犬 解	犭 解
獯	犬 熏	犭 熏
狞	犬 宁	犭 宁
获	草 犬 犬	艸 犭 犬	艹 犭 犬
獴	犬 蒙	犭 蒙
猎	犬 昔	犭 昔
犷	犬 广	犭 广
兽	丷 田 一 口
獭	犬 赖	犭 赖
献	南 犬
猕	犭 弥
猡	犬 罗	犭 罗
玄	亠 幺
率	玄 冰 丶 丶 十	玄 冫 丶 丶 十
玉	王 丶
王	一 土	一 一 丨 一	二 十	三 丨	二 丄
玎	玉 丁	王 丁
玕	玉 干	王 干
玖	玉 久	王 久
玠	玉 介	王 介
玡	玉 牙	王 牙
玢	玉 分	王 分
玥	玉 月	王 月
玦	玉 夬	王 夬
玩	玉 元	王 元
玫	玉 攴	王 攵
玲	玉 令	王 令
玳	玉 代	王 代
玷	玉 占	王 占
玻	玉 皮	王 皮
珀	玉 白	王 白
珂	玉 可	王 可
珈	玉 加	王 加
珉	玉 民	王 民
珍	玉 人 彡	王 人 彡
珏	玉 玉	王 玉
珙	玉 共	王 共
珞	玉 各	王 各
珠	玉 朱	王 朱
珣	玉 旬	王 旬
珥	玉 耳	王 耳
珧	玉 兆	王 兆
珩	玉 行	王 行
班	王 刂 王	玉 刂 王
珽	玉 廷	王 廷
现	玉 见	王 见
球	玉 求	王 求
理	玉 里	王 里
琇	玉 秀	王 秀
琉	玉 亠 厶 川	王 亠 厶 川	王 巟	玉 㐬	王 㐬
琚	玉 居	王 居
琛	玉 罙	王 罙
琢	玉 豖	王 豖
琤	玉 爭	王 爭
琥	玉 虎	王 虎
琦	玉 奇	王 奇
琨	玉 昆	王 昆
琪	玉 其	王 其
琫	玉 奉	王 奉
琬	玉 宛	王 宛
琮	玉 宗	王 宗
琯	玉 官	王 官
琰	玉 炎	王 炎
琳	玉 林	王 林
琴	玉 玉 今	王 王 今
琵	玉 比	王 比
琶	玉 巴	王 巴
珐	玉 法 琺	王 法 琺
珲	玉 军	王 军
瑀	玉 禹	王 禹
瑁	玉 冒	王 冒
瑄	玉 宣	王 宣
玮	玉 韦	王 韦
玚	玉 弓 丿 丿	王 弓 丿 丿
瑕	玉 叚
瑗	玉 爰	王 爰
瑙	玉 巛 囟	王 巛 囟
瑚	玉 胡	王 胡
瑛	玉 英	王 英
瑜	玉 俞	王 俞
瑞	玉 耑	王 耑
瑟	玉 必	王 必
瑢	玉 容	王 容
琐	玉 小 贝	王 小 贝
瑶	玉 爪 缶	王 爫 缶
莹	艹 冖 玉
玛	玉 马	王 马
瑭	玉 唐	王 唐
琅	玉 良	王 良
瑰	玉 鬼	王 鬼
瑾	玉 堇	王 堇
璀	玉 崔	王 崔
璁	玉 悤	王 悤
璃	玉 离	王 离
璆	玉 翏	王 翏
璇	玉 旋	王 旋
璈	玉 敖	王 敖
琏	玉 连	王 连
璋	玉 章	王 章
璐	玉 路	王 路
璘	玉 粦	王 粦
璜	玉 黄		王 黄
璞	玉 菐	王 菐
璟	玉 景	王 景
璠	玉 番	王 番
琎	玉 进	王 进
玑	玉 几	王 几
璧	辟 玉
璨	玉 粲	王 粲
璩	玉 豦	王 豦
璪	玉 喿	王 喿
珰	玉 当	王 当
环	玉 不	王 不
玙	玉 与	王 与
玺	尔 玉
琼	玉 京	王 京
珑	玉 龙	王 龙
璎	玉 婴	王 婴
瓘	玉 雚	王 雚
瓒	玉 赞	王 赞
瓜	爪 一 丶
瓞	瓜 失
瓠	夸 瓜
瓢	票 瓜
瓣	辛 瓜 辛
瓤	襄 瓜
瓮	公 瓦
瓴	令 瓦
瓶	并 瓦
瓷	次 瓦
瓻	希 瓦
瓿	咅 瓦
甄	垔 瓦
瓯	区 瓦
甏	彭 瓦
甑	曽 瓦	曾 瓦
甓	辟 瓦
甘	廿 一
甙	甘 弋
甚	甘 匹	其 乚
甜	舌 甘
生	牛 一	丿 三 丨
产	立 丿
甥	生 男
用	月 丨	冂 十 一
甩	月 乚
甪	丶 用
甫	一 丶 用
甬	龴 用
甭	不 用
田	囗 十
由	囗 十
甲	囗 十
申	囗 十
男	田 力
甸	勹 田
町	田 丁
甾	巛 田
畀	田 丌
留	卯 田
畈	田 反
畋	田 攴	田 攵
界	田 介
畎	田 犬
畔	田 半
畚	厶 大 田
畛	田 人 彡
畜	玄 田
亩	亠 田
毕	比 十
略	田 各
畦	田 圭	田 土 土
番	釆 田	采 田
画	一 由 凵
畯	田 夋
异	已 廾	己 廾
畲	余 田
畸	田 奇
畹	田 宛
畿	幺 幺 戈 田	幾 田
疃	田 童
疆	弓 土 畺
畴	田 寿
叠	叒 冝
疍	疋 旦
疏	疋 亠 厶 川	疋 巟	疋 㐬
疑	匕 矢 龴 疋
疔	病 丁	疒 丁
疙	病 乞	疒 乞
疚	病 久	疒 久
疝	病 山	疒 山
疢	病 火	疒 火
疣	病 尤	疒 尤
疤	病 巴	疒 巴
疥	病 介	疒 介
疫	病 殳	疒 殳
疰	病 主	疒 主
疱	病 包	疒 包
疲	病 皮	疒 皮
疳	病 甘	疒 甘
疴	病 可	疒 可
疵	病 此	疒 此
疸	病 旦	疒 旦
疹	病 人 彡	疒 人 彡
疼	病 冬	疒 冬
疽	病 且	疒 且
疾	病 矢	疒 矢
痂	病 加	疒 加
痃	病 玄	疒 玄
痄	病 乍	疒 乍
病	病 丙	疒 丙
症	病 正	疒 正
痊	病 全	疒 全
痍	病 夷	疒 夷
痔	病 寺	疒 寺
痕	病 艮	疒 艮
痘	病 豆	疒 豆
痉	病 圣	疒 圣
痛	病 甬	疒 甬
痞	病 否	疒 否
痢	病 利	疒 利
痣	病 志	疒 志
痤	病 坐	疒 坐
痦	病 吾	疒 吾
痧	病 沙	疒 沙
痰	病 炎	疒 炎
痱	病 非	疒 非
麻	广 林
痹	病 畀	疒 畀
痼	病 固	疒 固
痿	病 委	疒 委
瘁	病 卒	疒 卒
瘃	病 豖	疒 豖
瘊	病 侯	疒 侯
疯	病 风	疒 风
瘌	病 剌	疒 剌
疡	病 弓 丿 丿	疒 弓 丿 丿
瘐	病 臾	疒 臾
痪	病 奂	疒 奂
瘙	病 蚤	疒 蚤
瘛	病 恝	疒 恝
瘟	病 昷	疒 昷
瘠	病 脊	疒 脊
疮	病 仓	疒 仓
瘢	病 般	疒 般
瘤	病 留	疒 留
瘥	病 差	疒 差
瘦	病 叟	疒 叟
疟	病 匸 一	疒 匸 一
瘩	病 荅	疒 荅
瘭	病 票	疒 票
瘆	病 参	疒 参
瘰	病 累	疒 累
瘗	病 夹	疒 夹
疭	病 从	疒 从
瘳	病 翏	疒 翏
瘴	病 章	疒 章
瘵	病 祭	疒 祭
瘸	病 加 肉	疒 加 肉
瘘	病 娄	疒 娄
瘼	病 莫	疒 莫
癀	病 黄		疒 黄
疗	病 了	疒 了
癃	病 隆	疒 隆
痨	病 劳	疒 劳
痫	病 闲	疒 闲
瘅	病 单	疒 单
癌	病 品 山	疒 品 山	疒 喦
癍	病 斑	疒 斑
癔	病 意	疒 意
癖	病 辟	疒 辟
疠	病 万	疒 万
癜	病 殿	疒 殿
瘪	病 自 仑	疒 自 仑
痴	病 知	疒 知
痒	病 羊	疒 羊
疖	病 节	疒 节
疬	病 历	疒 历
癞	病 赖	疒 赖
癣	病 鲜	疒 鲜
瘿	病 婴	疒 婴
瘾	病 隐	疒 隐
癯	病 瞿	疒 瞿
痈	病 用	疒 用
瘫	病 难	疒 难
癫	病 颠	疒 颠
癸	癶 天
发	丿 友 丶	丿 一 丿 又 丶
登	癶 豆
白	丿 日	丶 日
百	一 白
皂	白 七
的	白 勺
皆	比 白
皇	白 王
皈	白 反
皋	白 夲	白 大 十	白 本
皎	白 交
皓	白 告
皖	白 完
皑	白 岂
皤	白 番
皮	乛 丿 丨 又	丿 支
皴	夋 皮
皲	军 皮
皱	刍 皮
皿	冊 一
盂	于 皿
盅	中 皿
盆	分 皿
盈	乃 又 皿	夃 皿
盉	禾 皿
益	丷 一 八 皿
盍	去 皿
盎	央 皿
盒	合 皿
盔	灰 皿
盛	成 皿
盗	次 皿
盏	戋 皿
盟	明 皿
监	丨 丨 丿 一 丶 皿
盘	舟 皿
盥	臼 水 皿
盦	今 酉 皿
卢	卜 尸
荡	草 汤	艸 汤	艹 汤
目	囗 二
盯	目 丁
盱	目 于
盲	目 亡
直	十 目 丨 一
相	木 目
盹	目 屯
盼	目 分
盾	厂 十 目
省	少 目
眄	目 丏
眇	目 少
眈	目 冘
眉	尸 丶 目
眊	目 毛
看	手 目
眙	目 台
眚	生 目
真	十 目 一 八	直 八
眠	目 民
眢	夗 目
眦	目 此
眨	目 乏
眩	目 玄
眭	目 圭
眵	目 多
眶	目 匡
眷	丷 夫 目	𠔉 目
眸	目 牟
眺	目 兆
眼	目 艮
众	人 人 人
睃	目 夋
睇	目 弟
睚	目 厓
睛	目 青
睁	目 争
睐	目 来
睡	目 垂
睢	目 隹
督	叔 目
睥	目 卑
睦	目 坴	目 土 儿 土
睨	目 兒
睫	目 疌
睬	目 采
睹	目 者
睽	目 癸
睾	丶 目 幸	丶 罒 幸
睿	卜 冖 一 八 人 目
瞀	敄 目
瞄	目 苗
瞅	目 秋
眯	目 米
瞌	目 盍	目 去 皿
瞍	目 叟
瞎	目 害
瞑	目 冥
眍	目 区
瞒	目 草 两	目 艹 两
瞟	目 票
瞠	目 堂
瞢	草 网 冖 目	艸 网 冖 目	艹 罒 冖 目
瞥	敝 目
瞧	目 焦
瞪	目 登
瞬	目 舜
瞰	目 敢
瞳	目 童
瞵	目 粦
瞻	目 詹
睑	目 佥
瞽	鼓 目
瞿	目 目 隹
矍	瞿 又	目 目 隻	目 目 隹 又
眬	目 龙
矗	直 直 直
瞩	目 属
矛	予 丿
矜	矛 今
矢	丿 天
矣	厶 矢
知	矢 口
矧	矢 引
矩	矢 巨
矬	矢 坐
短	矢 豆
矮	矢 委
矫	矢 乔
石	一 丿 口
矸	石 干
矻	石 乞
矽	石 夕
矾	石 凡
砂	石 少
砉	丰 石
砌	石 切
砍	石 欠
砑	石 牙
砒	石 比
研	石 开
砘	石 屯
砝	石 去
砟	石 乍
砣	石 它
砥	石 氐
砧	石 占
砭	石 乏
砮	奴 石
砰	石 平
破	石 皮
砷	石 申
砸	石 匝
砹	石 艾
砼	石 仝
硅	石 圭
硇	石 囟
硌	石 各
硎	石 刑
硐	石 同
硒	石 西
硁	石 圣
硝	石 肖
硖	石 夹
砗	石 车
硪	石 我
硫	石 亠 厶 川	石 巟	石 㐬
硬	石 更
硭	石 芒
砚	石 见
硼	石 朋
碇	石 定
碉	石 周
碌	石 录
碎	石 卒
碑	石 卑
碓	石 隹
碗	石 宛
碘	石 典
碚	石 咅
碟	石 枼	石 世 木
碡	石 毒
碣	石 曷
碥	石 扁
碧	王 白 石
硕	石 页
砀	石 弓 丿 丿
碰	石 並
碱	石 咸
碲	石 帝
碳	石 炭
碴	石 查
碶	石 契
砜	石 风
碹	石 宣
确	石 角
码	石 马
碾	石 展
磁	石 茲	石 兹
磅	石 旁
磉	石 桑
磊	石 石 石
磋	石 差
磐	般 石
磔	石 桀
磕	石 盍	石 去 皿
磙	石 衮
砖	石 专
碜	石 参
碛	石 责
磨	麻 石
磬	声 殳 石	殸 石
矶	石 几
磲	石 渠
磴	石 登
磷	石 粦
磺	石 黄
硗	石 尧
礁	石 焦
硚	石 乔
礅	石 敦
硷	石 佥
礌	石 雷
础	石 出
礓	石 畺
碍	石 日 一 寸	石 㝵
礞	石 蒙
礤	石 蔡
矿	石 广
砺	石 厉
砾	石 乐
砻	龙 石
礳	石 磨
礴	石 薄
示	二 小
社	示 土	礻 土
祀	示 巳	礻 巳
祁	示 邑	礻 阝
祆	示 天	礻 天
祈	示 斤	礻 斤
祉	示 止	礻 止
祓	示 犮	礻 犮
祖	示 且	礻 且
祗	示 氐	礻 氐
祚	示 乍	礻 乍
祛	示 去	礻 去
祜	示 古	礻 古
祝	示 兄	礻 兄
神	示 申	礻 申
祟	出 示
祠	示 司	礻 司
祥	示 羊	礻 羊
祧	示 兆	礻 兆
票	西 示	襾 示	覀 示
祭	夗 示
祲	示 彐 冖 又	礻 彐 冖 又
祺	示 其	礻 其
祼	示 果	礻 果
祾	示 夌	礻 夌
禄	示 录	礻 录
禁	林 示
禊	示 契	礻 契
祸	示 呙	礻 呙
祯	示 贞	礻 贞
福	示 畐	礻 畐
祎	示 韦	礻 韦
禚	示 羔	礻 羔
祃	示 马	礻 马
禤	示 目 羽	礻 罒 羽
禧	示 喜	礻 喜
禅	示 单	礻 单
礼	示 乚	礻 乚
祢	示 尓	礻 尔
祷	示 寿	礻 寿
禳	示 襄	礻 襄
禹	丿 口 冂 厶
禺	甲 禸	日 禸
禽	人 离
禾	丿 木
秃	禾 几
秀	禾 乃
私	禾 厶
秆	禾 干
秉	禾 聿	禾 肀	丿 一 彐 丨 丿 乀
秋	禾 火
科	禾 斗
秒	禾 少
秕	禾 比
秘	禾 必
租	禾 且
秣	禾 末
秤	禾 平
秦	手 乀 禾	龹 禾
秧	禾 央
秩	禾 失
秫	禾 朮
秭	禾 丿 ㇉ 丨 丿
秸	禾 吉
移	禾 多
稀	禾 希
稂	禾 良
税	禾 兑
稆	禾 吕
程	禾 呈
稍	禾 肖
稔	禾 念
稗	禾 卑
稚	禾 隹
稞	禾 果
禀	亠 回 示
稠	禾 周
种	禾 中
称	禾 尔
稻	禾 舀
稷	禾 田 儿 夕	禾 田 儿 夂	禾 畟
稼	禾 家
稽	禾 尤 旨
稿	禾 高
谷	八 人 口
穗	禾 惠
穄	禾 祭
穆	禾 白 小 彡
稣	鱼 禾
积	禾 只
颖	匕 禾 页
稳	禾 急
秾	禾 农
穑	禾 啬
秽	禾 岁
穰	禾 襄
穴	宀 八
究	穴 九
穸	穴 夕
穹	穴 弓
空	穴 工
穿	穴 牙
窀	穴 屯
突	穴 犬
窄	穴 乍
窅	穴 目
窈	穴 幼
窒	穴 至
窕	穴 兆
窖	穴 告
窗	穴 囱
窘	穴 君
窟	穴 屈
窠	穴 果
窣	穴 卒
窨	穴 音
窝	穴 呙
洼	水 圭	氵 圭
窬	穴 俞
穷	穴 力
窑	穴 缶
窳	穴 瓜 瓜
窭	穴 娄
窸	穴 悉
窥	穴 规
窿	穴 隆
窜	穴 串
窍	穴 巧
窦	穴 卖
窃	穴 切
立	亠 丷 一
竑	立 厷
站	立 占
龙	尤 丿
竟	立 日 儿
章	立 早
竣	立 夋
童	立 里
竦	立 束
竖	丨 丨 又 立
竭	立 曷
端	立 耑	立 山 而
竞	立 兄
竹	丿 一 丨 丿 一 亅
竺	竹 二
竽	竹 于
竿	竹 干
笄	竹 开
笆	竹 巴
笈	竹 及
笊	竹 爪
笏	竹 勿
笑	竹 夭
笙	竹 生
笛	竹 由
笞	竹 台
笠	竹 立
笤	竹 召
笥	竹 司
符	竹 付
笨	竹 本
笪	竹 旦
笫	竹 丿 ㇉ 丨 丿
第	竹 弔 丿	竹 弓 丨 丿
笮	竹 乍
笱	竹 句
笳	竹 加
笸	竹 叵
筅	竹 先
笔	竹 毛
筇	竹 邛
等	竹 寺
筋	竹 肉 力	竹 月 力
筌	竹 全
笋	竹 尹
筏	竹 伐
筐	竹 匡
筒	竹 同
答	竹 合
策	竹 朿
筘	竹 扣
筠	竹 均
筢	竹 把
笕	竹 见
筮	竹 巫
筱	竹 攸
筲	竹 肖
筵	竹 延
筷	竹 快
筻	竹 更
箅	竹 畀
笺	竹 戋
箍	竹 手 匝	竹 扌 匝	竹 才 匝
筝	竹 争
箐	竹 青
箔	竹 泊
箕	竹 其
算	竹 目 廾
箜	竹 空
管	竹 官
箢	竹 宛
箬	竹 若
箭	竹 前
箱	竹 相
箴	竹 咸
箸	竹 者
节	竹 卩
篁	竹 皇
范	草 氾	艸 氾	艹 氾
篆	竹 彖
篇	竹 扁
筑	竹 巩
箧	竹 匚 夹
篌	竹 侯
筼	竹 员
篙	竹 高
篚	竹 匪
篝	竹 冓
篡	竹 目 大 厶
笃	竹 马
篥	竹 栗
篦	竹 囟 比
筛	竹 师
篪	竹 虒
笼	竹 龙
筚	竹 毕
篷	竹 逢
篼	竹 兜
篾	竹 网 戍	竹 罒 戍	竹 罓 戍
箦	竹 责
簃	竹 移
簇	竹 族
簉	竹 造
簋	竹 艮 皿
簌	竹 欶
篓	竹 娄
簏	竹 鹿
箫	竹 肃
箪	竹 単
簟	竹 覃
簠	竹 盙
简	竹 间
篑	竹 贵
簦	竹 登
簧	竹 黄
檐	木 詹
簸	竹 其 皮
筜	竹 当
签	竹 佥
簿	竹 薄
籀	竹 手 留	竹 扌 留
篮	竹 监
筹	竹 寿
籍	竹 耤
箓	竹 录
箨	竹 择
籁	竹 赖
笾	竹 边
簖	竹 断
篱	竹 离
箩	竹 罗
米	丷 木
籼	米 山
籽	米 子
粉	米 分
粑	米 巴
粒	米 立
粕	米 白
粗	米 且
粘	米 占
肃	聿 八 丿 丨	肀 八 丿 丨
粜	出 米
粞	米 西
粟	西 米	襾 米	覀 米
粥	弓 米 弓
粱	水 刀 八 米	氵 刀 八 米
粲	歹 又 米	歺 又 米
粳	米 更
粤	丶 冂 米 亏
粹	米 卒
粼	粦 巜
粽	米 宗
精	米 青
糅	米 柔
糇	米 侯
糈	米 胥
糊	米 胡
糌	米 夂 人 日
糍	米 兹
糕	米 羔
糖	米 唐
糗	米 臭
糙	米 造
糜	麻 米
糁	米 参
粪	米 共
糟	米 曹
糠	米 康
粮	米 良
糨	米 強
糯	米 需
粝	米 厉
籴	入 米
纠	丝 丩	纟 丩
纪	丝 己	纟 己
纣	丝 寸	纟 寸
约	丝 勺	纟 勺
红	丝 工	纟 工
纡	丝 于	纟 于
纥	丝 乞	纟 乞
纨	丝 丸	纟 丸
纫	丝 刃	纟 刃
紊	文 丝	文 糸
纹	丝 文	纟 文
纳	丝 内	纟 内
纽	丝 丑	纟 丑
纾	丝 予	纟 予
纯	丝 屯	纟 屯
纰	丝 比	纟 比
纱	丝 少	纟 少
纸	丝 氏	纟 氏
级	丝 及	纟 及
纷	丝 分	纟 分
纭	丝 云	纟 云
纴	丝 壬	纟 壬
素	丰 丝	丰 糸
纺	丝 方	纟 方
索	十 冖 丝	十 冖 糸
紫	此 丝	此 糸
累	田 糸	田 丝
细	丝 田	纟 田
绂	丝 犮	纟 犮	丝 友 丶	纟 友 丶
绁	丝 世	纟 世
绅	丝 申	纟 申
纻	丝 宀 一	纟 宀 一
绍	丝 召	纟 召
绀	丝 甘	纟 甘
绋	丝 弗	纟 弗
绌	丝 出	纟 出
终	丝 冬	纟 冬
组	丝 且	纟 且
绊	丝 半	纟 半
经	丝 圣	纟 圣
绗	丝 行	纟 行
结	丝 吉	纟 吉
绝	丝 色	纟 色
绔	丝 夸	纟 夸
绞	丝 交	纟 交
络	丝 各	纟 各
绚	丝 旬	纟 旬
给	丝 合	纟 合
绒	丝 戎	纟 戎
絮	如 丝	如 糸
统	丝 充	纟 充
丝	丝 丝	纟 纟
绛	丝 夅	纟 夅
绘	丝 会	纟 会
绢	丝 肙	纟 肙	丝 口 月
绑	丝 邦	纟 邦
绡	丝 肖	纟 肖
绠	丝 更	纟 更
绨	丝 弟	纟 弟
绤	丝 谷	纟 谷
绥	丝 妥	纟 妥
综	丝 宗	纟 宗
绿	丝 录	纟 录
绸	丝 周	纟 周
绻	丝 卷	纟 卷
綦	其 糸
线	丝 戋	纟 戋
绶	丝 受	纟 受
维	丝 隹	纟 隹
綮	戶 攵 糸	户 攵 糸
绹	丝 匋	纟 匋
绾	丝 官	纟 官
纲	丝 冈	纟 冈
网	冂 乂 乂
绷	丝 朋	纟 朋
缀	丝 叕	纟 叕
纶	丝 仑	纟 仑
绺	丝 咎	纟 咎
绮	丝 奇	纟 奇
绽	丝 定	纟 定
绰	丝 卓	纟 卓
绫	丝 夌	纟 夌
绵	丝 帛	纟 帛
绲	丝 昆	纟 昆
缁	丝 甾	纟 甾
紧	丨 丨 又 丝
绯	丝 非	纟 非
总	丷 口 心
绪	丝 者	纟 者
缃	丝 相	纟 相
缄	丝 咸	纟 咸
缂	丝 革	纟 革
缉	丝 咠	纟 咠	丝 口 耳
缎	丝 段	纟 段
缔	丝 帝	纟 帝
缗	丝 昬	纟 昬
缘	丝 彖	纟 彖
缌	丝 思	纟 思
编	丝 扁	纟 扁
缓	丝 爰	纟 爰
缅	丝 面	纟 面
纬	丝 韦	纟 韦
缑	丝 侯	纟 侯
缈	丝 目 少	纟 目 少
练	丝 东 一	纟 东 一
缏	丝 便	纟 便
缇	丝 是	纟 是
致	至 攴
缠	丝 厘	纟 厘
萦	草 冖 丝	艹 冖 丝
缙	丝 晋	纟 晋
缢	丝 益	纟 益
缒	丝 追	纟 追
绉	丝 刍	纟 刍
缣	丝 兼	纟 兼
缚	丝 尃	纟 尃
缜	丝 真	纟 真
缟	丝 高	纟 高
缛	丝 辱	纟 辱
县	且 厶
纵	丝 从	纟 从
绦	丝 条	纟 条
缝	丝 逢	纟 逢
缡	丝 离	纟 离
缩	丝 宿	纟 宿
缧	丝 累	纟 累
缦	丝 曼	纟 曼
絷	执 糸
缕	丝 娄	纟 娄
缥	丝 票	纟 票
縻	麻 糸
绩	丝 责	纟 责
繁	每 攴 丝	每 攵 糸
繄	殹 糸
缫	丝 巢	纟 巢
缪	丝 翏	纟 翏
繇	月 缶 系
绣	丝 秀	纟 秀
缯	丝 曾	纟 曾
织	丝 只	纟 只
缮	丝 善	纟 善
缭	丝 尞	纟 尞
绕	丝 尧	纟 尧
绳	丝 黾	纟 黾
茧	草 虫
缰	丝 畺	纟 畺
缳	丝 睘	纟 睘
缲	丝 喿	纟 喿
缴	丝 敫	纟 敫
绎	丝 又 二 丨	纟 又 二 丨
继	丝 丨 一 米	纟 丨 一 米	纟 𠃊 米
缤	丝 宾	纟 宾
缱	丝 遣	纟 遣
纂	竹 目 大 絲	竹 目 大 糸	竹 目 大 丝
缬	丝 颉	纟 颉
纩	丝 广	纟 广
续	丝 卖	纟 卖
缨	丝 婴	纟 婴
纤	丝 千	纟 千
缵	丝 赞	纟 赞
纛	毒 縣
缆	丝 览	纟 览
缶	丿 二 山
缸	缶 工
缺	缶 夬
钵	金 本	钅 本
罄	声 殳 缶	殸 缶
罅	缶 虖
罂	贝 贝 缶
罐	缶 雚
罔	冂 丷 一 亡
罕	网 干	罓 干	冖 八 干	㓁 干
罘	网 不	罒 不
罟	网 古	罒 古
罡	网 正	罒 正
罨	网 奄	罒 奄
罩	网 卓	罒 卓	罓 卓
罪	网 非	罒 非	罓 非
置	网 直	罒 直	罓 直
罚	网 言 刀	罒 讠 刂	罓 讠 刂
罱	网 南	罒 南
署	网 者	罒 者
骂	口 口 马
罢	网 去	罒 去
罹	网 心 隹	罒 忄 隹	罓 忄 隹
罽	网 厂 剡	罒 厂 剡
罾	网 曾	罒 曾
罗	网 夕	罒 夕	罓 夕
罴	罢 火	罢 灬
羁	网 革 马	罒 革 马
羊	丷 三 丨
羌	羊 儿
美	羊 大
羑	羊 久
羔	羊 火	羊 灬
羚	羊 令
羝	羊 氐
羞	羊 丿 丑
群	君 羊
羟	羊 圣
羧	羊 夋
羡	羊 次
义	丶 乂
羯	羊 曷
羰	羊 炭
羲	羊 禾 丂 戈
羸	亡 口 月 羊 凡
羹	羔 美
羼	尸 羴
羽	习 习
羿	羽 廾
翁	公 羽
翅	支 羽
翊	立 羽
翌	羽 立
翎	令 羽
习	刁 丶
翔	羊 羽
翕	合 羽
翟	羽 隹
翠	羽 卒
翡	非 羽
翥	者 羽
翦	前 羽
翩	扁 羽
翚	羽 军
翮	鬲 羽
翯	羽 高
翰	十 日 十 人 羽
翳	殹 羽
翘	尧 羽
翱	皋 羽
翻	番 羽
翼	羽 異
翙	岁 羽
耀	光 翟
老	土 丿 匕	耂 匕	老 匕
考	土 丿 丂	耂 丂	老 丂
耄	老 毛
者	土 丿 日	耂 日	老 日
耆	老 日
耋	老 至
而	一 丶 冂 丨 丨
耍	而 女
耐	而 寸
耒	二 木	一 未	末 一
耔	耒 子
耕	耒 井
耖	耒 少
耗	耒 毛
耘	耒 云
耙	耒 巴
耜	耒 尸 乛 一
耠	耒 合
耥	耒 尚
耦	耒 禺
耨	耒 辱
耩	耒 冓
耪	耒 旁
耧	耒 娄
耢	耒 劳
耰	耒 憂
耱	耒 磨
耲	耒 褱
耵	耳 丁
耶	耳 邑	耳 阝
耷	大 耳
耽	耳 冘
耿	耳 火
聃	耳 冉
聆	耳 令
聊	耳 卯
聒	耳 舌
圣	又 土
聘	耳 甹	耳 由 丂
聚	耳 又 乑
闻	门 耳
联	耳 关
聪	耳 总
聱	敖 耳
声	士 尸 丨
耸	从 耳
听	口 斤
聩	耳 贵
聂	耳 又 又
职	耳 只
聍	耳 宁
聋	龙 耳
聿	彐 二 丨
肄	匕 矢 聿
肆	镸 聿
肇	戶 攴 聿	户 攴 聿	户 攵 聿	戸 攵 聿
肉	冂 人 人	冂 入 入
肋	肉 力	月 力
肌	肉 几	月 几
肓	亡 肉	亡 月
肖	小 肉	小 月
肘	肉 寸	月 寸
肚	肉 土	月 土
肛	肉 工	月 工
肝	肉 干	月 干
肟	肉 亏	月 亏
股	肉 殳	月 殳
肢	肉 支	月 支
肥	肉 巴	月 巴
肩	戶 肉	戶 月	户 月	戸 月
肪	肉 方	月 方
肫	肉 屯	月 屯
肭	肉 內	月 內
肮	肉 亢	月 亢
肯	止 肉	止 月
肱	肉 厷	月 厷
育	亠 厶 肉	亠 厶 月
肷	肉 欠	月 欠
肺	肉 巿	月 巿
肼	肉 井	月 井
肽	肉 太	月 太
胂	肉 申	月 申
胃	田 肉	田 月
胄	由 肉	由 月
胍	肉 瓜	月 瓜
胎	肉 台	月 台
胖	肉 半	月 半
胗	肉 人 彡	月 人 彡
胙	肉 乍	月 乍
胚	肉 丕	月 丕
胛	肉 甲	月 甲
胝	肉 氐	月 氐
胞	肉 包	月 包
胡	古 肉	古 月
胤	丿 幺 肉 乚	丿 幺 月 乚
胥	疋 月
胩	肉 卡	月 卡
胬	奴 肉	奴 月
胭	肉 因	月 因
胯	肉 夸	月 夸
胰	肉 夷	月 夷
胱	肉 光	月 光
胲	肉 亥	月 亥
胳	肉 各	月 各
胴	肉 同	月 同
胸	肉 匈	月 匈
胺	肉 安	月 安
能	厶 肉 匕 匕	厶 月 匕 匕
脂	肉 旨	月 旨
胁	肉 办	月 办
脆	肉 危	月 危
脉	肉 永	月 永	肉 𠂢 脈	月 𠂢 脈
脊	肉 人 二 二	月 人 二 二
脎	肉 杀	月 杀
脒	肉 米	月 米
脖	肉 孛	月 孛
脘	肉 完	月 完
胫	肉 圣	月 圣
脞	肉 坐	月 坐
脱	肉 兑	月 兑
脬	肉 孚	月 孚
脯	肉 甫	月 甫
脲	肉 尿	月 尿
胀	肉 长	月 长
脾	肉 卑	月 卑
胼	肉 并	月 并
腆	肉 典	月 典
腈	肉 青	月 青
腋	肉 夜	月 夜
肾	丨 丨 又 肉	丨 丨 又 月
腐	府 肉	广 付 肉
腑	肉 府	月 府
腒	肉 居	月 居
腓	肉 非	月 非
腔	肉 空	月 空
腕	肉 宛	月 宛
胨	肉 东	月 东
腙	肉 宗	月 宗
腚	肉 定	月 定
腠	肉 奏	月 奏
脶	肉 呙	月 呙
腥	肉 星	月 星
脑	肉 亠 乂 凵	月 亠 乂 凵
腧	肉 俞	月 俞
腩	肉 南	月 南
肿	肉 中	月 中
腭	肉 咢	月 咢
腮	肉 思	月 思
腰	肉 要	月 要
腱	肉 建	月 建
脚	肉 却	月 却
腴	肉 臾	月 臾
肠	肉 弓 丿 丿	月 弓 丿 丿
腹	肉 复	月 复
腺	肉 泉	月 泉
腿	肉 退	月 退
膀	肉 旁	月 旁
膂	旅 肉	旅 月
腽	肉 昷	月 昷
膈	肉 鬲	月 鬲
膊	肉 尃	月 尃
膏	高 肉	高 月
膘	肉 票	月 票
膙	肉 強	月 強
肤	肉 夫	月 夫
膛	肉 堂	月 堂
膜	肉 莫	月 莫
膝	肉 桼	月 桼
胶	肉 交	月 交
膦	肉 粦	月 粦
膨	肉 彭	月 彭
腻	肉 贰	月 贰
膪	肉 啻	月 啻
膳	肉 善	月 善
膺	广 人 隹 肉	广 人 隹 月	广 亻 隹 肉	广 倠 肉
膻	肉 亶	月 亶
胆	肉 旦	月 旦
脍	肉 会	月 会
脓	肉 农	月 农
臀	肉 殿	月 殿
臁	肉 廉	月 廉
臂	肉 辟	月 辟
臃	肉 雍	月 雍
臆	肉 意	月 意
脸	肉 佥	月 佥
臊	肉 喿	月 喿
臌	肉 鼓	月 鼓
脐	肉 齐	月 齐
膑	肉 宾	月 宾
臑	肉 需	月 需
脏	肉 庄	月 庄
腊	肉 昔	月 昔
胪	肉 卢	月 卢
脔	亦 肉
臜	肉 赞	月 赞
臣	巨 丨 丨	巨 丶 丶
卧	臣 卜
臧	一 爿 乀 丿 丶 臣	爿 戊 臣
临	丨 丨 丿 一 丶 口 丨
自	丶 目
臬	自 木
臭	自 犬
至	一 厶 土
臻	至 秦
臼	丿 丨 一 彐
臾	臼 人
舀	爪 臼	爫 臼
舂	夫 一 臼
舄	臼 勹 火	臼 勹 灬
舅	臼 男
与	一 ㇉ 一
兴	丷 六
举	兴 二 丨
旧	丨 日
舌	千 口
舐	舌 氏
舒	舍 予
舔	舌 忝
铺	金 甫	钅 甫
舛	夕 匸 丨
舜	爪 冖 舛	爫 冖 舛
舞	丿 一 卌 一 舛	丿 一 一 丨 丨 丨 丨 一 舛
舟	丶 冂 一 丶 丶	丶 冂 一 丶 丨
舢	舟 山
舨	舟 反
航	舟 亢
舫	舟 方
般	舟 殳
舳	舟 由
舴	舟 乍
舵	舟 它
舶	舟 白
舷	舟 玄
舸	舟 可
船	舟 八 口
舾	舟 西
艄	舟 肖
艇	舟 廷
艋	舟 孟
艘	舟 叟
舱	舟 仓
艚	舟 曹
艟	舟 童
舣	舟 义
舰	舟 见
艨	舟 蒙
舻	舟 卢
良	丶 艮
艰	又 艮
色	刀 巴
艴	弗 色
艳	丰 色
艽	草 九	艸 九	艹 九
艾	草 乂	艸 乂	艹 乂
艿	草 乃	艸 乃	艹 乃
芄	草 丸	艸 丸	艹 丸
芈	草 卝 二 丨	艸 卝 二 丨	艹 卝 二 丨
芊	草 千	艸 千	艹 千
芋	草 于	艸 于	艹 于
芍	草 勺	艸 勺	艹 勺
芎	草 弓	艸 弓	艹 弓
芏	草 土	艸 土	艹 土
芑	草 己	艸 己	艹 己
芒	草 亡	艸 亡	艹 亡
芙	草 夫	艸 夫	艹 夫
芝	草 之	艸 之	艹 之
芟	草 殳	艸 殳	艹 殳
芡	草 欠	艸 欠	艹 欠
芥	草 介	艸 介	艹 介
芨	草 及	艸 及	艹 及
芩	草 今	艸 今	艹 今
芪	草 氏	艸 氏	艹 氏
芫	草 元	艸 元	艹 元
芬	草 分	艸 分	艹 分
芭	草 巴	艸 巴	艹 巴
芮	草 內	艸 內	艹 內
芯	草 心	艸 心	艹 心
芰	草 支	艸 支	艹 支
花	草 化	艸 化	艹 化
芳	草 方	艸 方	艹 方
芴	草 勿	艸 勿	艹 勿
芷	草 止	艸 止	艹 止
芸	草 云	艸 云	艹 云
芹	草 斤	艸 斤	艹 斤
芼	草 毛	艸 毛	艹 毛
芽	草 牙	艸 牙	艹 牙
芾	草 巿	艸 巿	艹 巿
苄	草 卞	艸 卞	艹 卞
苊	草 厄	艸 厄	艹 厄
苑	草 夗	艸 夗	艹 夗
苒	草 冉	艸 冉	艹 冉
苓	草 令	艸 令	艹 令
苔	草 台	艸 台	艹 台
苕	草 召	艸 召	艹 召
苗	草 田	艸 田	艹 田
苘	草 冋	艸 冋	艹 冋
苛	草 可	艸 可	艹 可
苜	草 目	艸 目	艹 目
苞	草 包	艸 包	艹 包
苟	草 句	艸 句	艹 句
苠	草 民	艸 民	艹 民
苡	草 以	艸 以	艹 以
苣	草 巨	艸 巨	艹 巨
苤	草 丕	艸 丕	艹 丕
若	草 右	艸 右	艹 右
苦	草 古	艸 古	艹 古
苎	草 宀 一	艸 宀 一	艹 宀 一
苫	草 占	艸 占	艹 占
苯	草 本	艸 本	艹 本
英	草 央	艸 央	艹 央
苴	草 且	艸 且	艹 且
苷	草 甘	艸 甘	艹 甘
苻	草 付	艸 付	艹 付
茀	草 弗	艸 弗	艹 弗
茁	草 出	艸 出	艹 出
茂	草 戊	艸 戊	艹 戊
茄	草 加	艸 加	艹 加
茅	草 矛	艸 矛	艹 矛
茆	草 卯	艸 卯	艹 卯
茈	草 此	艸 此	艹 此
茉	草 末	艸 末	艹 末
茌	草 仕	艸 仕	艹 仕
茓	草 穴	艸 穴	艹 穴
茗	草 名	艸 名	艹 名
茚	草 印	艸 印	艹 印
茛	草 艮	艸 艮	艹 艮
茜	草 西	艸 西	艹 西
茝	草 臣	艸 臣	艹 臣
茨	草 次	艸 次	艹 次
茫	草 水 亡	艸 氵 亡	艹 氵 亡
茬	草 在	艸 在	艹 在
茭	草 交	艸 交	艹 交
茯	草 伏	艸 伏	艹 伏
茱	草 朱	艸 朱	艹 朱
兹	丷 一 幺 幺
茳	草 江	艸 江	艹 江
茴	草 回	艸 回	艹 回
茵	草 因	艸 因	艹 因
茶	草 人 一 小	艸 人 一 小	艹 人 一 小
茸	草 耳	艸 耳	艹 耳
茹	草 如	艸 如	艹 如
茼	草 同	艸 同	艹 同
荀	草 旬	艸 旬	艹 旬
荃	草 全	艸 全	艹 全
荇	草 行	艸 行	艹 行
草	草 早	艸 早	艹 早
荆	井 刀	井 刂
荏	草 任	艸 任	艹 任
荑	草 夷	艸 夷	艹 夷
荒	草 巟	艸 巟	艹 巟
荔	草 劦	艸 劦	艹 劦
庄	广 土
荷	草 何	艸 何	艹 何
荸	草 孛	艸 孛	艹 孛
荻	草 狄	艸 狄	艹 狄
荼	草 余	艸 余	艹 余
荽	草 妥	艸 妥	艹 妥
莆	草 甫	艸 甫	艹 甫
莉	草 利	艸 利	艹 利
莎	草 沙	艸 沙	艹 沙
莒	草 吕	艸 吕	艹 吕
莓	草 每	艸 每	艹 每
茎	草 圣	艸 圣	艹 圣
莘	草 辛	艸 辛	艹 辛
莙	草 君	艸 君	艹 君
莛	草 廷	艸 廷	艹 廷
莜	草 攸	艸 攸	艹 攸
莞	草 完	艸 完	艹 完
莠	草 秀	艸 秀	艹 秀
荚	草 夹	艸 夹	艹 夹
苋	草 见	艸 见	艹 见
莩	草 孚	艸 孚	艹 孚
莪	草 我	艸 我	艹 我
莫	草 日 大	艸 日 大	艹 日 大	艹 曰 大
莰	草 坎	艸 坎	艹 坎
莽	草 大 廾	艸 大 廾	艹 大 廾
菀	草 宛	艸 宛	艹 宛
菁	草 青	艸 青	艹 青
菂	草 的	艸 的	艹 的
菅	草 官	艸 官	艹 官
菇	草 姑	艸 姑	艹 姑
菊	草 匊	艸 匊	艹 匊	草 勹 米
菌	草 囷	艸 囷	艹 囷
菏	草 河	艸 河	艹 河
菔	草 服	艸 服	艹 服
菖	草 昌	艸 昌	艹 昌
菘	草 松	艸 松	艹 松
菜	草 采	艸 采	艹 采
菝	草 犮	艸 犮	艹 犮
菟	草 兔	艸 兔	艹 兔
菠	草 波	艸 波	艹 波
菡	草 函	艸 函	艹 函
菥	草 析	艸 析	艹 析
菩	草 咅	艸 咅	艹 咅
菪	草 宕	艸 宕	艹 宕
华	化 十
菰	草 孤	艸 孤	艹 孤
菱	草 夌	艸 夌	艹 夌
菲	草 非	艸 非	艹 非
菹	草 沮	艸 沮	艹 沮
菼	草 炎	艸 炎	艹 炎
菽	草 叔	艸 叔	艹 叔
萁	草 其	艸 其	艹 其
萃	草 卒	艸 卒	艹 卒
萄	草 匋	艸 匋	艹 匋
苌	草 长	艸 长	艹 长
莱	草 来	艸 来	艹 来
萋	草 妻	艸 妻	艹 妻
萌	草 明	艸 明	艹 明
萍	草 水 平	艸 氵 平	艹 氵 平
萎	草 委	艸 委	艹 委
萏	草 臽	艸 臽	艹 臽
荠	草 齐	艸 齐	艹 齐
萘	草 奈	艸 奈	艹 奈
萜	草 帖	艸 帖	艹 帖
萩	草 秋	艸 秋	艹 秋
萱	草 宣	艸 宣	艹 宣
莴	草 呙	艸 呙	艹 呙
萸	草 臾	艸 臾	艹 臾
萼	草 咢	艸 咢	艹 咢
落	草 洛	艸 洛	艹 洛
葆	草 保	艸 保	艹 保
叶	口 十
葑	草 封	艸 封	艹 封
荭	草 红	艸 红	艹 红
葓	草 洪	艸 洪	艹 洪
葖	草 突	艸 突	艹 突
着	羊 丿 目
著	草 者	艸 者	艹 者
葚	草 甚	艸 甚	艹 甚
葛	草 曷	艸 曷	艹 曷
葜	草 契	艸 契	艹 契
葡	草 匍	艸 匍	艹 匍
董	草 重	艸 重	艹 重
苇	草 韦	艸 韦	艹 韦
葩	草 皅	艸 皅	艹 皅
葫	草 胡	艸 胡	艹 胡
葬	草 死 廾	艸 死 廾	艹 死 廾
葭	草 叚	艸 叚	艹 叚
药	草 约	艸 约	艹 约
葳	草 威	艸 威	艹 威
葵	草 癸	艸 癸	艹 癸
葶	草 亭	艸 亭	艹 亭
荤	草 军	艸 军	艹 军
葸	草 思	艸 思	艹 思
葺	草 咠	艸 咠	艹 咠	草 口 耳
蒂	草 帝	艸 帝	艹 帝
蒈	草 皆	艸 皆	艹 皆
蒎	草 派	艸 派	艹 派
莼	草 纯	艸 纯	艹 纯
莳	草 时	艸 时	艹 时
蒗	草 浪	艸 浪	艹 浪
蒜	草 示 示	艸 示 示	艹 示 示
莅	草 位	艸 位	艹 位
蒟	草 立 句	艸 立 句	艹 立 句
蒡	草 旁	艸 旁	艹 旁
蒯	萠 刀	萠 刂
蒲	草 浦	艸 浦	艹 浦
蒴	草 朔	艸 朔	艹 朔
蒸	草 烝	艸 烝	艹 烝
蒹	草 兼	艸 兼	艹 兼
蒺	草 疾	艸 疾	艹 疾
苍	草 仓	艸 仓	艹 仓
蒽	草 恩	艸 恩	艹 恩
蒿	草 高	艸 高	艹 高
荪	草 孙	艸 孙	艹 孙
蓁	草 秦	艸 秦	艹 秦
蓂	草 冥	艸 冥	艹 冥
蓄	草 畜	艸 畜	艹 畜
蓇	草 骨	艸 骨	艹 骨
蓉	草 容	艸 容	艹 容
蓊	草 翁	艸 翁	艹 翁
盖	草 羊 皿	艸 羊 皿	艹 羊 皿
蓍	草 耆	艸 耆	艹 耆
蓐	草 辱	艸 辱	艹 辱
蓑	草 衰	艸 衰	艹 衰
蓓	草 倍	艸 倍	艹 倍
蓖	草 囟 比	艸 囟 比	艹 囟 比
蓬	草 逢	艸 逢	艹 逢
莲	草 连	艸 连	艹 连
苁	草 从	艸 从	艹 从
蓰	草 徙	艸 徙	艹 徙
蓼	草 翏	艸 翏	艹 翏
荜	草 毕	艸 毕	艹 毕
蓿	草 宿	艸 宿	艹 宿
蔌	草 欶	艸 欶	艹 欶
蔑	草 网 戍	艸 罓 戍	艹 罒 戍
蔓	草 曼	艸 曼	艹 曼
蔗	草 庶	艸 庶	艹 庶
蔚	草 尉	艸 尉	艹 尉
蒌	草 娄	艸 娄	艹 娄
蔟	草 族	艸 族	艹 族
蔡	草 祭	艸 祭	艹 祭
蒋	草 将	艸 将	艹 将
葱	草 怱	艸 怱	艹 怱
茑	草 鸟	艸 鸟	艹 鸟
蔫	草 焉	艸 焉	艹 焉
蔬	草 疏	艸 疏	艹 疏
荫	草 阴	艸 阴	艹 阴
蔸	草 兜	艸 兜	艹 兜
蔻	草 寇	艸 寇	艹 寇
蔽	草 敝	艸 敝	艹 敝
荨	草 寻	艸 寻	艹 寻
蕃	草 番	艸 番	艹 番
蒇	草 戊 贝	艸 戊 贝	艹 戊 贝
蕈	草 覃	艸 覃	艹 覃
蕉	草 焦	艸 焦	艹 焦
蕊	草 惢	艸 惢	艹 惢	芯 心 心
荞	草 乔	艸 乔	艹 乔
荬	草 买	艸 买	艹 买
莸	草 犹	艸 犹	艹 犹
蕖	草 渠	艸 渠	艹 渠
荛	草 尧	艸 尧	艹 尧
蕙	草 惠	艸 惠	艹 惠
蕞	草 最	艸 最	艹 最
蒉	草 贵	艸 贵	艹 贵
蕤	草 豕 生	艸 豕 生	艹 豕 生
蕨	草 厥	艸 厥	艹 厥
芜	草 无	艸 无	艹 无
萧	草 肃	艹 肃	艸 肃
蓣	草 预	艸 预	艹 预
蕹	草 雍	艸 雍	艹 雍
蕺	草 戢	艸 戢	艹 戢
蕻	草 镸 共	艸 镸 共	艹 镸 共
蕾	草 雷	艸 雷	艹 雷
蕰	草 温	艸 温	艹 温
薄	草 水 甫 寸	艸 氵 尃	艹 氵 尃
薅	草 媷	艸 媷	艹 媷
薇	草 微	艸 微	艹 微
荟	草 会	艸 会	艹 会
蓟	草 鱼 刀	艸 鱼 刂	艹 鱼 刂
芗	草 乡	艸 乡	艹 乡
薏	草 意	艸 意	艹 意
蔷	草 啬	艸 啬	艹 啬
荙	草 达	艸 达	艹 达
薛	草 户 乛 一 辛	艸 户 乛 一 辛	艹 户 乛 一 辛
薜	草 辟	艸 辟	艹 辟
莶	草 佥	艸 佥	艹 佥
薤	草 歹 韭	艸 歹 韭	艹 歹 韭
荐	草 存	艸 存	艹 存
薨	草 网 冖 死	艸 罒 冖 死	艹 罒 冖 死
萨	草 阜 产	艸 阜 产	艹 阝 产
薪	草 新	艸 新	艹 新
薰	草 熏	艸 熏	艹 熏
薯	草 署	艸 署	艹 署
薷	草 需	艸 需	艹 需
薹	草 臺	艸 臺	艹 臺
藁	草 槀	艸 槀	艹 槀	蒿 木
蓝	草 监	艸 监	艹 监
荩	草 尽	艸 尽	艹 尽
藏	草 臧	艸 臧	艹 臧
藐	草 貌	艸 貌	艹 貌
藕	草 耦	艸 耦	艹 耦
藜	草 黎	艸 黎	艹 黎
藠	草 皛	艸 皛	艹 皛
藤	草 滕	艸 滕	艹 滕
藩	草 潘	艸 潘	艹 潘
薮	草 数	艸 数	艹 数
蕴	草 缊	艸 缊	艹 缊
苈	草 历	艸 历	艹 历
蔼	草 谒	艸 谒	艹 谒
蔺	草 门 隹	艸 门 隹	艹 门 隹
藻	草 澡	艸 澡	艹 澡
藿	草 霍	艸 霍	艹 霍
蕲	草 单 斤	艸 单 斤	艹 单 斤
蘅	草 衡	艸 衡	艹 衡
芦	草 户	艸 户	艹 户
苹	草 平	艸 平	艹 平
蘑	草 磨	艸 磨	艹 磨
蘖	草 檗	艸 檗	艹 檗	薛 木
蘘	草 襄	艸 襄	艹 襄
藓	草 鲜	艸 鲜	艹 鲜
蔹	草 敛	艸 敛	艹 敛
茏	草 龙	艸 龙	艹 龙
蘧	草 豦	艸 豦	艹 豦
蘩	草 繁	艸 繁	艹 繁
兰	丷 三
蘸	草 酉 隹 火	艸 酉 隹 灬	艹 酉 隹 灬
蓠	草 离	艸 离	艹 离
蘼	草 靡	艸 靡	艹 靡
萝	草 罗	艸 罗	艹 罗
虎	虎 儿	虍 儿
虐	虎 匸 一	虍 匸 一
虔	虎 文	虍 文
虚	虎 业	虍 业
虏	虎 力	虍 力
虞	虎 吴	虍 吴
号	口 丂
虢	寽 虎
亏	一 丂
虬	虫 乚
虱	乁 一 虫
虹	虫 工
虺	兀 虫
虻	虫 亡
虼	虫 乞
蚊	虫 文
蚋	虫 内
蚌	虫 丰
蚍	虫 比
蚓	虫 引
蚜	虫 牙
蚝	虫 毛
蚣	虫 公
蚤	叉 丶 虫
蚧	虫 介
蚨	虫 夫
蚩	屮 一 虫		山 一 虫
蚯	虫 丘
蚰	虫 由
蚱	虫 乍
蚴	虫 幼
蚶	虫 甘
蚺	虫 冉
蛀	虫 主
蛄	虫 古
蛆	虫 且
蛇	虫 它
蛉	虫 令
蛋	疋 虫
萤	草 冖 虫	艸 冖 虫	艹 冖 虫
蛐	虫 曲
蛑	虫 牟
蛔	虫 回
蛘	虫 羊
蛙	虫 圭
蛛	虫 朱
蛞	虫 舌
蛟	虫 交
蛤	虫 合
蛩	巩 虫
蛭	虫 至
蛸	虫 肖
蛹	虫 甬
蛱	虫 夹
蜕	虫 兑
蛾	虫 我
蜀	罒 勹 虫
蜂	虫 夆
蜃	辰 虫
蚬	虫 见
蜇	折 虫
蜈	虫 吴
蜉	虫 孚
蜊	虫 利
蜍	虫 余
蜎	虫 肙
蜒	虫 延
蜓	虫 廷
蜘	虫 知
蜚	虫 非
蜜	宀 必 虫	宓 虫
蜞	虫 其
蜢	虫 孟
蜣	虫 羌
蜥	虫 析
蜩	虫 周
蜮	虫 或
蜱	虫 卑
蜴	虫 易
蜷	虫 卷
蜻	虫 青
蜾	虫 果
蜿	虫 宛
蜡	虫 昔
蝌	虫 科
蝎	虫 曷
蝓	虫 俞
蚀	食 虫	饣 虫
蝗	虫 皇
蝙	虫 扁
猬	犬 胃	犭 胃
蝠	虫 畐
蝣	虫 斿
蝤	虫 酋
蝥	敄 虫
虾	虫 下
蝮	虫 复
蝰	虫 奎
蝴	虫 胡
蝶	虫 枼
蜗	虫 呙
蝻	虫 南
蝽	虫 春
蝇	虫 黾
螂	虫 郎
螃	虫 旁
蛳	虫 师
螅	虫 息
螈	虫 原
螋	虫 叟
融	鬲 虫
螗	虫 唐
蚂	虫 马
螟	虫 冥
螠	虫 益
螣	丷 夫 虫	𠔉 虫
螫	赦 虫
螬	虫 曹
螭	虫 离
螯	敖 虫
螳	虫 堂
螵	虫 票
螺	虫 累
蝼	虫 娄
螽	冬 虫 虫
蟀	虫 率
蛰	执 虫
蟆	虫 莫
蝈	虫 国
蟊	矛 虫 虫
蟋	虫 悉
螨	虫 草 两	虫 艸 两	虫 艹 两
蟑	虫 章
蟒	虫 莽
蟛	虫 彭
蟠	虫 番
虮	虫 几
蟥	虫 黄
蟪	虫 惠
蝉	虫 单
蟮	虫 善
蛲	虫 尧
虫	口 厶
蛏	虫 圣
蟹	解 虫
蚁	虫 义
蟾	虫 詹
蠃	亡 口 月 虫 凡
虿	万 虫
蠊	虫 廉
蠋	虫 蜀
蛴	虫 齐
蝾	虫 荣
蠓	虫 蒙
蠕	虫 需
蠖	虫 蒦
蠡	彖 虫 虫
蠢	春 虫 虫
蛎	虫 厉
蛊	虫 皿
蠲	益 蜀
蚕	天 虫
蠹	一 中 冖 石 虫 虫
蛮	亦 虫
蠼	虫 瞿 又
血	丶 皿	丿 皿
衄	血 丑
行	彳 亍
衍	行 水	行 氵
术	木 丶
街	行 圭	行 土 土
衙	行 吾
卫	卩 一
衡	行 刀 田 大
衢	行 瞿
衣	丶 一 
表	丰 
衩	衣 叉	衤 叉
衫	衣 彡	衤 彡
衰	衣 中 一
衲	衣 内	衤 内
衷	衣 中	一 中 衣
衽	衣 壬	衤 壬
衾	今 衣
衿	衣 今	衤 今
袁	土 口 衣
袂	衣 夬	衤 夬
袈	加 衣
袋	代 衣
袍	衣 包	衤 包
袒	衣 旦	衤 旦
袖	衣 由	衤 由
袗	衣 人 彡	衤 人 彡
衮	衣 公
袢	衣 半	衤 半
袤	衣 矛
袪	衣 去	衤 去
被	衣 皮	衤 皮
袱	衣 伏	衤 伏
袼	衣 各	衤 各
裁	十 戈 衣	土 戈 衣	𢦏 衣
裂	列 衣
裉	衣 艮	衤 艮
袅	勹 丶 丨 ㇆ 衣
裎	衣 呈	衤 呈
里	甲 二	田 土
裒	衣 臼
裔	衣 冏
裕	衣 谷	衤 谷
裘	衣 求
裙	衣 君	衤 君
补	衣 卜	衤 卜
装	壮 衣
裟	沙 衣
裨	衣 卑	衤 卑
裰	衣 叕	衤 叕
裱	衣 表	衤 表
裳	尚 衣
裴	非 衣
裸	衣 果	衤 果
裹	衣 果
裼	衣 易	衤 易
裾	衣 居	衤 居
褂	衣 卦	衤 卦
褊	衣 扁	衤 扁
裈	衣 军	衤 军
褐	衣 曷	衤 曷
褒	保 衣	亠 保 衣
褓	衣 保	衤 保
袆	衣 韦	衤 韦
褙	衣 背	衤 背
褚	衣 者	衤 者
褡	衣 荅	衤 荅
褥	衣 辱	衤 辱
褪	衣 退	衤 退
褫	衣 虒	衤 虒
褰	宀 井 大 衣
裤	衣 库	衤 库
裢	衣 连	衤 连
褶	衣 習	衤 習
褛	衣 娄	衤 娄
亵	执 衣
襄	口 口 井 一 衣
裥	衣 间	衤 间
袯	衣 发	衤 发
袄	衣 夭	衤 夭
裣	衣 佥	衤 佥
襞	辟 衣
襟	衣 禁	衤 禁
裆	衣 当	衤 当
褴	衣 监	衤 监
襦	衣 需	衤 需
袜	衣 末	衤 末
衬	衣 寸	衤 寸
襕	衣 阑	衤 阑
襻	衣 攀	衤 攀
西	一 口 儿	一 囗 儿	一 四
要	西 女	襾 女	覀 女
覃	西 早	襾 早	覀 早
覆	西 復	覀 復
霸	雨 革 月
见	冂 丿 乚
观	又 见
规	夫 见
觅	爪 见	爫 见
视	示 见	礻 见
觇	占 见
觉	小 冖 见
觋	巫 见
觎	俞 见
览	丨 丨 丿 一 丶 网 见	丨 丨 丿 一 丶 罒 见
亲	立 木
觊	岂 见
觏	冓 见
觐	堇 见
觑	虚 见
觌	卖 见
觖	角 夬
觚	角 瓜
觜	此 角
解	角 刀 牛
觥	角 光
觫	角 束
觱	咸 角
觳	士 冖 角 殳
觞	角 丿 一 弓 丿 丿
觯	角 单
触	角 虫
言	二 二 口	丶 一 二 口
订	言 丁	讠 丁
讣	言 卜	讠 卜
訇	勹 言
计	言 十	讠 十
讯	言 卂	讠 卂
讧	言 工	讠 工
讨	言 寸	讠 寸
讦	言 干	讠 干
训	言 川	讠 川
讪	言 山	讠 山
讫	言 乞	讠 乞
记	言 己	讠 己
讹	言 化	讠 化
讶	言 牙	讠 牙
讼	言 公	讠 公
诀	言 夬	讠 夬
讷	言 內	讠 內
访	言 方	讠 方
设	言 殳	讠 殳
许	言 午	讠 午
译	言 又 二 丨	讠 又 二 丨
诉	言 斥	讠 斥
诃	言 可	讠 可
诊	言 人 彡	讠 人 彡
訾	此 言
诂	言 古	讠 古
诋	言 氐	讠 氐	言 氏 丶
詈	目 言	罒 言
讵	言 巨	讠 巨
诈	言 乍	讠 乍
诒	言 台	讠 台
诏	言 召	讠 召
评	言 平	讠 平
诐	言 皮	讠 皮
诎	言 出	讠 出
诅	言 且	讠 且
词	言 司	讠 司
咏	口 永
诩	言 羽	讠 羽
询	言 旬	讠 旬
诣	言 旨	讠 旨
试	言 式	讠 式
诗	言 寺	讠 寺
诧	言 宅	讠 宅
诟	言 后	讠 后
诡	言 危	讠 危
诠	言 全	讠 全
诘	言 吉	讠 吉
话	言 舌	讠 舌
该	言 亥	讠 亥
详	讠 羊	讠 羊
诜	言 先	讠 先
詹	刀 厂 儿 言
诙	言 灰	讠 灰
诖	言 圭	讠 圭
诔	言 耒	讠 耒
诛	言 朱	讠 朱
诓	言 匡	讠 匡
认	言 人	讠 人
诳	言 狂	讠 狂
誓	折 言
诞	言 延	讠 延
诱	言 秀	讠 秀
诮	言 肖	讠 肖
语	言 吾	讠 吾
诚	言 成	讠 成
诫	言 戒	讠 戒
诬	言 巫	讠 巫
误	言 吴	讠 吴
诰	言 告	讠 告
诵	言 甬	讠 甬
诲	言 每	讠 每
说	言 兑	讠 兑
读	言 卖	讠 卖
谁	言 隹	讠 隹
课	言 果	讠 果
谇	言 卒	讠 卒
诽	言 非	讠 非
谊	言 宜	讠 宜
调	言 周	讠 周
谄	言 臽	讠 臽
谆	言 享	讠 享
谈	言 炎	讠 炎
诿	言 委	讠 委
请	言 青	讠 青
诤	言 争	讠 争
诹	言 取	讠 取
诼	言 豖	讠 豖
谅	言 京	讠 京
论	言 仑	讠 仑
谂	言 念	讠 念
谀	言 臾	讠 臾
谍	言 枼	讠 枼	言 世 木
谝	言 扁	讠 扁
谥	言 兮 皿	讠 兮 皿
诨	言 军	讠 军
谔	言 咢	讠 咢
谛	言 帝	讠 帝
谐	言 皆	讠 皆
谏	言 柬	讠 柬
谕	言 俞	讠 俞
讳	言 韦	讠 韦
谙	言 音	讠 音
谌	言 甚	讠 甚
讽	言 风	讠 风
诸	言 者	讠 者
谚	言 彦	讠 彦
谖	言 爰	讠 爰
诺	言 若	讠 若
谋	訁 某	讠 某
谒	言 曷	讠 曷
谓	言 胃	讠 胃
誊	丷 夫 言	𠔉 言
诌	言 刍	讠 刍
謇	宀 井 大 言
谎	言 荒	讠 荒
谜	言 迷	讠 迷
谧	言 必 皿	讠 必 皿
谑	言 虐	讠 虐
谡	言 畟	讠 畟
谤	言 旁	讠 旁
谦	言 兼	讠 兼
讲	言 井	讠 井
谢	言 射	讠 射
谣	言 爪 缶	讠 爫 缶
谟	言 莫	讠 莫
谪	言 啇	讠 啇
谬	言 翏	讠 翏
谫	言 剪	讠 剪
讴	言 区	讠 区
谨	言 堇	讠 堇
谩	言 曼	讠 曼
证	言 正	讠 正
谲	言 矞	讠 矞
讥	言 几	讠 几
谮	言 旡 旡 日	讠 旡 旡 日	言 朁	讠 朁
识	言 只	讠 只
谯	言 焦	讠 焦
谭	言 覃	讠 覃
谱	言 普	讠 普
谠	言 当	讠 当
警	敬 言
谵	言 詹	讠 詹
譬	辟 言
议	言 义	讠 义
谴	言 遣	讠 遣
护	手 户	扌 户	才 户
誉	兴 言
雠	隹 言 隹	雔 言	隹 讠 隹
谗	言 免 冫	讠 免 冫
让	言 上	讠 上
谰	言 阑	讠 阑
谶	言 韱	讠 韱
赞	先 先 贝
谳	言 献	讠 献
豁	害 谷
豆	一 口 丷 一
豇	豆 工
岂	山 己
豉	豆 支
豌	豆 宛
豕	一 丿 亅 丿 丿 丶 乀
豚	肉 豕	月 豕
象	刀 口 丨 豕	刀 冖 丨 豕
豢	八 夫 豕	丷 夫 豕	𠔉 豕
豨	豕 希
豪	亠 口 冖 豕
豫	予 象
猪	犬 者	犭 者
豳	山 豩	豕 山 豕
豸	丿 丶 丶 丿 亅 丿 丿
豹	豸 勺
豺	豸 才
貂	豸 召
貅	豸 休
貉	豸 各
貊	豸 百
貌	豸 白 儿
猫	犬 苗	犭 苗
貔	豸 囟 比
獾	犬 雚	犭 雚
贝	冂 人
贞	卜 贝
负	刀 贝
财	贝 才
贡	工 贝
贫	分 贝
货	化 贝
贩	贝 反
贪	今 贝
贯	母 贝
责	丰 贝
贮	贝 宀 一
贳	世 贝
贰	弋 二 贝
贵	中 一 贝
贬	贝 乏
买	乛 头
贷	代 贝
贶	贝 兄
费	弗 贝
贴	贝 占
贻	贝 台
贸	卯 贝
贺	加 贝
贲	十 艹 贝
赂	贝 各
赁	任 贝
贿	贝 有
赅	贝 亥
资	次 贝
贾	西 贝	覀 贝	襾 贝
贼	贝 戎
贱	贝 戋
赈	贝 辰
赊	贝 佘
宾	宀 兵
赇	贝 求
赉	来 贝
赐	贝 易
赏	尚 贝
赔	贝 咅
赓	庚 贝
贤	丨 丨 又 贝
赋	贝 武
质	厂 十 贝
赍	十 人 人 冖 贝
账	贝 长
赌	贝 者
赖	束 负
赚	贝 兼
赙	贝 尃
购	贝 勾
赛	宀 井 大 贝
贽	执 贝
赘	敖 贝
赟	斌 贝
赠	贝 曾
赝	厂 人 隹 贝	厂 亻 隹 贝	厂 倠 贝
赡	贝 詹
赢	亡 口 月 贝 凡
赆	贝 尽
赃	贝 庄
赑	贝 贝 贝
赎	贝 卖
赣	立 早 夕 工 贝	立 早 夂 工 贝
赤	土 丿 亅 八
赦	赤 攴	赤 攵
赧	赤 卩 又
赫	赤 赤
赪	赤 贞
赭	赤 者
走	十 疋
赳	走 丩
赴	走 卜
起	走 己
趁	走 人 彡
趄	走 且
超	走 召
越	走 戉
趑	走 次
趔	走 列
赶	走 干
赵	走 乂
趟	走 尚
趣	走 取
趋	走 刍
趱	走 赞
足	口 卜 人
趴	足 八
趵	足 勺
趺	足 夫
趼	足 开
趾	足 止
趿	足 及
跆	足 台
跋	足 犮
跌	足 失
跎	足 它
跏	足 加
跑	足 包
跖	足 石
跗	足 付
跚	足 册
跛	足 皮
距	足 巨
跟	足 艮
迹	辵 亦	辶 亦
跣	足 先
跤	足 交
跺	足 朵
跨	足 夸
跪	足 危
跬	足 圭
路	足 各
跳	足 兆
跽	足 忌
踅	折 足
踉	足 良
踏	足 沓
践	足 戋
踔	足 卓
踝	足 果
踞	足 居
踟	足 知
踢	足 易
踣	足 咅
踩	足 采
踮	足 店
踱	足 度
踊	足 甬
踵	足 重
踶	足 是
踹	足 耑
踺	足 建
踽	足 禹
蹀	足 枼
蹁	足 扁
蹂	足 柔
蹄	足 帝
蹅	足 查
蹇	宀 井 大 足
蹈	足 舀
蹉	足 差
蹊	足 奚
蹋	足 日 羽
跄	足 仓
蹐	足 脊
蹓	足 留
跸	足 毕
蹙	戚 足
蹜	足 宿
蹢	足 啇
蹒	足 草 两	足 艹 两
踪	足 宗
蹦	足 崩
蹩	敝 足
蹬	足 登
蹭	足 曾
蹯	足 番
蹲	足 尊
蹴	足 就
蹶	足 厥
跷	足 尧
蹼	足 菐
蹽	足 尞
蹾	足 敦
躁	足 品 木	足 喿
跶	足 达
躅	足 蜀
躇	足 著
趸	万 足
踌	足 寿
跻	足 齐
跃	足 夭
躐	足 巤
踯	足 郑
跞	足 乐
踬	足 质
躔	足 廛
蹰	足 厨
跹	足 迁
躞	足 燮
蹑	足 聂
蹿	足 窜
躜	足 赞
躏	足 蔺
身	丶 且 丿
躬	身 弓
躲	身 朵
躺	身 尚
躯	身 区
车	一 𠃋 十
轧	车 乚
轨	车 九 軌
军	冖 车
轪	车 大
轩	车 干
轫	车 刃
轭	车 厄
软	车 欠
转	车 专
轷	车 乎
轸	车 人 彡
轱	车 古
轴	车 由
轵	车 只
轺	车 召
轲	车 可
轶	车 失
轻	车 圣
轼	车 式
较	车 交
辂	车 各
辁	车 全
辀	车 舟
载	十 戈 车	土 戈 车	𢦏 车
轾	车 至
辆	车 两
辄	车 耴
辅	车 甫
辎	车 甾
辉	车 军
辋	车 罔
辍	车 叕
辊	车 昆
辇	夫 夫 车
辈	非 车
轮	车 仑
辌	车 京
辑	车 咠	车 口 耳
辏	车 奏
输	车 俞
辐	车 畐
辒	车 昷
辗	车 展
舆	臼 车 一 八
毂	士 冖 车 殳
辖	车 害
辕	车 袁
辘	车 鹿
辙	车 彳 育 攵
轿	车 乔
辚	车 粦
轰	车 又 又
辔	丝 车 口
轳	车 卢
辛	立 十
辜	古 辛
辟	尸 口 辛
辣	辛 束
办	力 八
辨	辛 丶 丿 辛
辞	舌 辛
辫	辛 丝 辛	辛 纟 辛
辩	辛 言 辛	辛 讠 辛
辰	厂 衣
辱	辰 寸
农	冖 
边	辵 力	辶 力
迂	辵 于	辶 于
迄	辵 乞	辶 乞
迅	辵 卂	辶 卂
迎	辵 卬	辶 卬
近	辵 斤	辶 斤
迓	辵 牙	辶 牙
返	辵 反	辶 反
迕	辵 午	辶 午
迢	辵 召	辶 召
迤	辵 丿 一 也	辶 丿 一 也
迥	辵 冋	辶 冋
迦	辵 加	辶 加
迨	辵 台	辶 台
迪	辵 由	辶 由
迫	辵 白	辶 白
迭	辵 失	辶 失
迮	辵 乍	辶 乍
述	辵 术	辶 术
迷	辵 米	辶 米
迸	辵 并	辶 并
追	辵 戶 乛 一	辶 戶 乛 一	辵 户 乛 一	辶 户 乛 一
退	辵 艮	辶 艮
送	辵 关	辶 关
逃	辵 兆	辶 兆
逄	辵 夅	辶 夅
逅	辵 后	辶 后
逆	辵 屰	辶 屰
逋	辵 甫	辶 甫
逍	辵 肖	辶 肖
透	辵 秀	辶 秀
逐	辵 豕	辶 豕
逑	辵 求	辶 求
途	辵 余	辶 余
逖	辵 狄	辶 狄
逗	辵 豆	辶 豆
这	辵 文	辶 文
通	辵 甬	辶 甬
逛	辵 狂	辶 狂
逝	辵 折	辶 折
逞	辵 呈	辶 呈
速	辵 束	辶 束
造	辵 告	辶 告
逡	辵 夋	辶 夋
逢	辵 夆	辶 夆
连	辵 车	辶 车
逭	辵 官	辶 官
逮	辵 隶	辶 隶
逯	辵 彔	辶 彔
进	辵 井	辶 井
逵	辵 坴	辶 坴
逶	辵 委	辶 委
逸	辵 免	辶 免
远	辵 袁	辶 元
逼	辵 畐	辶 畐
逾	辵 俞	辶 俞
遁	辵 盾	辶 盾
遂	辵 丷 豕	辶 丷 豕
遄	辵 耑	辶 耑
遇	辵 禺	辶 禺
运	辵 云	辶 云
遍	辵 扁	辶 扁
过	辵 寸	辶 寸
遏	辵 曷	辶 曷
遐	辵 叚	辶 叚
遑	辵 皇	辶 皇
遒	辵 酋	辶 酋
道	辵 首	辶 首
达	辵 大	辶 大
违	辵 韦	辶 韦
遘	辵 冓	辶 冓
遥	辵 爪 缶	辶 爫 缶
遛	辵 留	辶 留
逊	辵 孙	辶 孙
递	辵 弟	辶 弟
遢	辵 日 羽	辶 日 羽	辵 曰 羽	辶 曰 羽
遣	辵 中 一 尸 乛 一	辶 辵 中 一 尸 乛 一
遨	辵 敖	辶 敖
适	辵 舌	辶 舌
遭	辵 曹	辶 曹
遮	辵 庶	辶 庶
迟	辵 尺	辶 尺
遴	辵 粦	辶 粦
遵	辵 尊	辶 尊
迁	辵 千	辶 千
选	辵 先	辶 先
遗	辵 贵	辶 贵
辽	辵 了	辶 了
遽	辵 豦	辶 豦
避	辵 辟	辶 辟
邀	辵 敫	辶 敫
迈	辵 万	辶 万
邂	辵 解	辶 解
邃	穴 遂	辵 穴 丷 豕	辶 穴 丷 豕
还	辵 不	辶 不
迩	辶 尔
邈	辵 貌	辶 貌
邋	辵 巤	辶 巤
逻	辵 罗	辶 罗
逦	辵 丽	辶 丽
邑	口 巴
邕	巛 邑
邗	干 邑	干 阝
邙	亡 邑	亡 阝
邛	工 邑	工 阝
邡	方 邑	方 阝
邢	开 邑	开 阝
那	月 邑	月 阝
邦	丰 邑	丰 阝
邪	牙 邑	牙 阝
邯	甘 邑	甘 阝
邰	台 邑	台 阝
邱	丘 邑	丘 阝
邳	丕 邑	丕 阝
邴	丙 邑	丙 阝
邵	召 邑	召 阝
邶	北 邑	北 阝
邸	氐 邑	氐 阝	氏 丶 邑
邽	圭 邑	圭 阝
邾	朱 邑	朱 阝
郁	有 邑	有 阝
郄	乂 厷 邑	乂 厷 阝
郅	至 邑	至 阝
郇	旬 邑	旬 阝
郈	后 邑	后 阝
郊	交 邑	交 阝
郎	良 邑	良 阝
郗	希 邑	希 阝
郚	吾 邑	吾 阝
郛	孚 邑	孚 阝
郜	告 邑	告 阝
郝	赤 邑	赤 阝
郏	夹 邑	夹 阝
郡	君 邑	君 阝
郢	呈 邑	呈 阝
郤	谷 邑	谷 阝
部	咅 邑	咅 阝
郫	卑 邑	卑 阝
郭	享 邑	享 阝
郯	炎 邑	炎 阝
郴	林 邑	林 阝
邮	由 邑	由 阝
都	者 邑	者 阝
郾	匽 邑	匽 阝
郿	眉 邑	眉 阝
鄂	咢 邑	咢 阝
鄄	垔 邑	垔 阝
郓	军 邑	军 阝
乡	𠃋 𠃋 丿
鄌	唐 邑	唐 阝
邹	刍 邑	刍 阝
邬	乌 邑	乌 阝
郧	员 邑	员 阝
鄘	庸 邑	庸 阝
鄙	啚 邑	啚 阝
鄞	堇 邑	堇 阝
鄢	焉 邑	焉 阝
鄣	章 邑	章 阝
邓	又 邑	又 阝
郑	关 邑	阝 邑
鄯	善 邑	善 阝
邻	令 邑	令 阝
鄱	番 邑	番 阝
郸	单 邑	单 阝
邺	业 邑	业 阝
郐	会 邑	会 阝
鄹	聚 邑	聚 阝
邝	广 邑	广 阝
酃	霝 邑	霝 阝
酆	豐 邑	豐 阝
郦	丽 邑	丽 阝
酉	西 一
酊	酉 丁
酋	丷 酉
酌	酉 勺
配	酉 己
酎	酉 寸
酏	酉 也
酐	酉 干
酒	水 酉	氵 酉
酗	酉 凶
酚	酉 分
酞	酉 太
酡	酉 它
酢	酉 乍
酣	酉 甘
酤	酉 古
酥	酉 禾
酩	酉 名
酪	各 酉
酬	酉 州
酮	酉 同
酯	酉 旨
酰	酉 先
酲	酉 呈
酴	酉 余
酵	酉 孝
酶	酉 每
酷	酉 告
酸	酉 夋
酹	酉 寽
腌	肉 奄	月 奄
醅	酉 咅
醇	酉 享
醉	酉 卒
醋	酉 昔
醌	酉 昆
醍	酉 是
醐	酉 胡
醑	酉 胥
醒	酉 星
酦	酉 发
醚	酉 迷
醛	酉 荃
酝	酉 云
醢	酉 右 皿
酱	丬 夕 酉
醪	酉 翏
医	匚 矢
醭	酉 菐
醮	酉 焦
醯	酉 亠 厶 川 皿	酉 巟 皿	酉 㐬 皿
醴	酉 豊
醵	酉 豦
醺	酉 熏
醾	酉 糜
酿	酉 良
衅	血 半
酾	酉 丽
酽	酉 严
释	采 又 二 丨	釆 又 二 丨
釉	采 由	釆 由
重	丿 一 里
野	里 予
量	日 一 里	曰 一 里
厘	厂 里
金	人 王 丷
钆	金 乚	钅 乚
钇	金 乙	钅 乙
钌	金 了	钅 了
钊	金 刀	钅 刂
钉	金 丁	钅 丁
钋	金 卜	钅 卜
釜	父 金
针	金 十	钅 十
钓	金 勺	钅 勺
钐	金 彡	钅 彡
钏	金 川	钅 川
钒	金 凡	钅 凡
钗	金 叉	钅 叉
钍	金 土	钅 土
钕	金 女	钅 女
钎	金 千	钅 千
钯	金 巴	钅 巴
钫	金 方	钅 方
钘	金 开	钅 开
钭	金 斗	钅 斗
钚	金 不	钅 不
钠	金 内	钅 内
钝	金 屯	钅 屯
钩	金 勾	钅 勾
钤	金 今	钅 今
钣	金 反	钅 反
钞	金 少	钅 少
钮	金 丑	钅 丑
钧	金 勻	钅 勻
钙	金 丐	钅 丐
钬	金 火	钅 火
钛	金 太	钅 太
钪	金 亢	钅 亢
铎	金 又 二 丨	钅 又 二 丨
铌	金 尼	钅 尼
铈	金 市	钅 市
铃	金 令	钅 令
钴	金 古	钅 古
钹	金 犮	钅 犮
铍	金 皮	钅 皮
钰	金 玉	钅 玉
铀	金 由	钅 由
钿	金 田	钅 田
钾	金 甲	钅 甲
铁	金 失	钅 失
铊	金 它	钅 它
铉	金 玄	钅 玄
铋	金 必	钅 必
铂	金 白	钅 白
钷	金 叵	钅 叵
钳	金 甘	钅 甘
铆	金 卯	钅 卯
铅	金 几 口	钅 几 口
钺	金 戉	钅 戉
钲	金 正	钅 正
钼	金 目	钅 目
钽	金 旦	钅 旦
铰	金 交	钅 交
铒	金 耳	钅 耳
铬	金 各	钅 各
铪	金 合	钅 合
银	金 艮	钅 艮
铳	金 充	钅 充
铜	金 同	钅 同
铚	金 至	钅 至
铣	金 先	钅 先
铨	金 全	钅 全
铢	金 朱	钅 朱
铭	金 名	钅 名
铫	金 兆	钅 兆
衔	行 金	行 钅
铑	金 老	钅 老
铷	金 如	钅 如
铱	金 衣	钅 衣
铟	金 因	钅 因
铵	金 安	钅 安
铥	金 丢	钅 丢
铕	金 有	钅 有
铯	金 色	钅 色
铐	金 考	钅 考
钱	金 戋	钅 戋
铞	金 吊	钅 吊
锐	金 兑	钅 兑
销	金 肖	钅 肖
锈	金 秀	钅 秀
锑	金 弟	钅 弟
锉	金 坐	钅 坐
铝	金 吕	钅 吕
锒	金 良	钅 良
锌	金 辛	钅 辛
钡	金 贝	钅 贝
铤	金 廷	钅 廷
铗	金 夹	钅 夹
锋	金 夆	钅 夆
铻	金 吾	钅 吾
锊	金 寽	钅 寽
锓	金 彐 冖 又	钅 彐 冖 又
铘	金 邪	钅 邪
锄	金 助	钅 助
锃	金 呈	钅 呈
锔	金 局	钅 局
锇	金 我	钅 我
锆	金 告	钅 告
锂	金 里	钅 里
铽	金 忒	钅 忒
铸	金 寿	钅 寿
锯	金 居	钅 居
钢	金 冈	钅 冈
锞	金 果	钅 果
锖	金 青	钅 青
锫	金 咅	钅 咅
锩	金 卷	钅 卷
锥	金 隹	钅 隹
锕	金 阿	钅 阿
锟	金 昆	钅 昆
锤	金 垂	钅 垂
锱	金 甾	钅 甾
铮	金 争	钅 争
锛	金 奔	钅 奔
锬	金 炎	钅 炎
锭	金 定	钅 定
锜	金 奇	钅 奇
锦	金 帛	钅 帛
锚	金 苗	钅 苗
锡	金 易	钅 易
锢	金 固	钅 固
错	金 昔	钅 昔
锰	金 孟	钅 孟
铼	金 来	钅 来
锝	金 日 一 寸	钅 日 一 寸	金 㝵	钅 㝵
锨	金 欣	钅 欣
锪	金 忽	钅 忽
钔	金 门	钅 门
锴	金 皆	钅 皆
锅	金 呙	钅 呙
镀	金 度	钅 度
锷	金 咢	钅 咢
铡	金 则	钅 则
锻	金 段	钅 段
锽	金 皇	钅 皇
锸	金 臿	钅 臿
锲	金 契	钅 契
锘	金 若	钅 若
锹	金 秋	钅 秋
锾	金 爰	钅 爰
键	金 建	钅 建
锶	金 思	钅 思
钟	金 中	钅 中
镁	金 美	钅 美
锿	金 哀	钅 哀
镅	金 眉	钅 眉
镑	金 旁	钅 旁
锁	金 小 贝	钅 小 贝
镉	金 鬲	钅 鬲
镈	金 尃	钅 尃
镃	金 兹	钅 兹
钨	金 乌	钅 乌
蓥	草 冖 金	艸 冖 金	艹 冖 金
镏	金 留	钅 留
铠	金 岂	钅 岂
铩	金 杀	钅 杀
镐	金 高	钅 高
镇	金 真	钅 真
镒	金 益	钅 益
镋	金 党	钅 党
镍	金 臬	钅 臬
镓	金 家	钅 家
镌	金 隽	钅 隽
镎	金 拿	钅 拿
镞	金 族	钅 族
链	金 连	钅 连
鏊	敖 金
镆	金 莫	钅 莫
镠	金 翏	钅 翏
镝	金 啇	钅 啇
鏖	鹿 金
铿	金 坚	钅 坚
锵	金 将	钅 将
镗	金 堂	钅 堂
镘	金 曼	钅 曼
镛	金 庸	钅 庸
铲	金 产	钅 产
镜	金 竟	钅 竟
镖	金 票	钅 票
镂	金 娄	钅 娄
錾	斩 金
镚	金 朋	钅 朋
铧	金 华	钅 华
镤	金 菐	钅 菐
镪	金 强	钅 强
铙	金 尧	钅 尧
铴	金 汤	钅 汤
镣	金 尞	钅 尞 鐐
铹	金 劳	钅 劳
镦	金 敦	钅 敦
镡	金 覃	钅 覃
镫	金 登	钅 登
镢	金 厥	钅 厥
镨	金 普	钅 普
锎	金 开	钅 开
锏	金 间	钅 间
镄	金 费	钅 费
镰	金 廉	钅 廉
镯	金 蜀	钅 蜀
镭	金 雷	钅 雷
铛	金 当	钅 当
鐾	辟 金
镱	金 意	钅 意
镬	金 蒦	钅 蒦
镔	金 宾	钅 宾
鉴	丨 丨 丿 一 丶 金	丨 丨 丿 一 丶 金
镲	金 察	钅 察
锧	金 质	钅 质
钻	金 占	钅 占
镴	金 巤	钅 巤
铄	金 乐	钅 乐
镳	金 鹿 灬	钅 鹿 灬
镥	金 鲁	钅 鲁
鑫	金 金 金
镧	金 阑	钅 阑
钥	金 月	钅 月
镵	金 毚	钅 毚
镶	金 襄	钅 襄
镊	金 聂	钅 聂
镩	金 窜	钅 窜
锣	金 罗	钅 罗
銮	亦 金
凿	丵 凵
门	丶 丨 ㇆
闩	门 一
闪	门 人
闭	门 才
开	一 廾
闶	门 亢
闳	门 厷
闰	门 王
闲	门 木
间	门 日
闵	门 文
闸	门 甲
闹	门 市
阂	门 亥
关	丷 天
阁	门 各
阀	门 伐
闺	门 圭
闽	门 虫
阃	门 困
阆	门 良
闾	门 吕
阅	门 兑
阊	门 昌
阉	门 奄
阎	门 臽
阏	门 於
阍	门 昏
阈	门 或
阌	门 受
阒	门 狊
闱	门 韦
阔	门 活
阕	门 癸
阑	门 柬
阇	门 者
阗	门 真
阘	门 日 羽
闿	门 岂
阖	门 盍
阙	门 欮
闯	门 马
阚	门 敢
阐	门 单
闼	门 达
阡	阜 千	阝 千
阢	阜 兀	阝 兀
阪	阜 反	阝 反
阮	阜 元	阝 元
阱	阜 井	阝 井
防	阜 方	阝 方
阻	阜 且	阝 且
阼	阜 乍	阝 乍
阽	阜 占	阝 占
阿	阜 可	阝 可
陀	阜 它	阝 它
陂	阜 皮	阝 皮
附	阜 付	阝 付
陋	阜 丨 一 丙	阝 丨 一 丙	阜 𠃊 丙	阝 𠃊 丙
陌	阜 百	阝 百
降	阜 夅	阝 夅
限	阜 艮	阝 艮
陔	阜 亥	阝 亥
陉	阜 圣	阝 圣
陛	阜 坒	阝 坒	阜 比 土	阝 比 土
陕	阜 夹	阝 夹
陟	阜 步	阝 步
陡	阜 走	阝 走
院	阜 完	阝 完
阵	阜 车	阝 车
除	阜 余	阝 余
陷	阜 臽	阝 臽
陧	阜 圼	阝 圼
陪	阜 咅	阝 咅
陬	阜 取	阝 取
阴	阜 月	阝 月
陲	阜 垂	阝 垂
陈	阜 东	阝 东
陴	阜 卑	阝 卑
陵	阜 夌	阝 夌
陶	阜 匋	阝 匋
陆	阜 击	阝 击
险	阜 佥	阝 佥
阳	阜 日	阝 日
隅	阜 禺	阝 禺
隆	阜 夂 生	阝 夂 生	阜 夕 生	阝 夕 生
隈	阜 畏	阝 畏
队	阜 人	阝 人
隋	阜 左 月	阝 左 月
隍	阜 皇	阝 皇
阶	阜 介	阝 介
隔	阜 鬲	阝 鬲
陨	阜 员	阝 员
隗	阜 鬼	阝 鬼
隘	阜 益	阝 益
隙	阜 小 日 小	阝 小 日 小
际	阜 示	阝 示
障	阜 章	阝 章
隐	阜 急	阝 急
隧	阜 遂	阝 遂
随	阜 迶	阝 迶	阜 辵 有
隳	阜 隋 人 心	阝 隋 人 心	阜 隋 人 小 丶	阝 隋 人 小 丶
陇	阜 龙	阝 龙
隶	彐 水
隼	隹 十
雀	少 隹
雁	厂 人 隹	厂 亻 隹	厂 倠
雄	厷 隹
雅	牙 隹
集	隹 木
萑	草 隹	艸 隹	艹 隹
雉	矢 隹
雌	此 隹
雍	亠 乡 隹
雎	且 隹
杂	九 木	九 朩
雒	各 隹
虽	口 虫
双	又 又
雏	刍 隹
鸡	又 鸟
离	离 隹 離
难	又 隹
雨	一 冂 丨 丶 丶 丶 丶
雩	雨 亏
雪	雨 彐
雯	雨 文
零	雨 令
雷	雨 田
雹	雨 包
电	日 乚
需	雨 而
霄	雨 肖
霆	雨 廷
震	雨 辰
霈	雨 沛
霉	雨 母
霍	雨 隹
霎	雨 妾
霏	雨 非
霓	雨 兒
霖	雨 林
霜	雨 相
霞	雨 叚
雾	雨 务
霪	雨 水 爪 壬	雨 氵 爫 壬
霰	雨 散
露	雨 路
霹	雨 辟
霁	雨 齐
霾	雨 貍
雳	雨 历
霭	雨 谒
灵	彐 火
青	丰 月	三 丨 月
靖	立 青
靓	青 见
靛	青 定
静	青 争
非	三 丿 丨 三
靠	告 非
靡	麻 非
面	一 丶 囬	一 丶 囗 丨 丨 一 一
腼	肉 面	月 面
靥	厌 面
革	廿 口 十
靰	革 兀
靳	革 斤
靴	革 化
靶	革 巴
靸	革 及
靺	革 末
靼	革 旦
靽	革 半
靿	革 幼
鞁	革 皮
鞅	革 央
鞋	革 圭
鞍	革 安
巩	工 凡
鞘	革 肖
鞠	革 匊	革 勹 米
鞡	革 拉
鞣	革 柔
鞧	革 酋
鞨	革 曷
鞫	革 訇
鞭	革 便
鞲	革 冓
鞴	革 草 厂 用	革 艸 厂 用	革 艹 厂 用
鞒	革 乔
韂	革 詹
鞑	革 达
鞯	革 荐
韦	二 ㇆ 丨
韧	韦 刃
韨	韦 犮	韦 友 丶
韩	十 日 十 韦
韪	是 韦
韬	韦 舀
韫	韦 昷
韭	非 一
齑	文 丿 丨 韭
音	立 日	立 曰
韶	音 召
韵	音 匀
页	一 丶 贝
顶	丁 页
顷	匕 页
项	工 页
顺	川 页
顸	干 页
须	彡 页
顼	玉 页	王 页
顾	厄 页
颂	公 页
颀	斤 页
颃	亢 页
预	予 页
顽	元 页
颁	分 页
顿	屯 页
颇	皮 页
领	令 页
颌	合 页
颉	吉 页
颐	匸 丨 口 丨 页
颏	亥 页
颊	夹 页
头	丶 丶 大
颋	廷 页
颔	含 页
颈	圣 页
颓	秃 页
频	步 页
颗	果 页
题	是 页
额	客 页
颚	咢 页
颜	彦 页
颙	禺 页
颛	耑 页
愿	原 心
颡	桑 页
颠	真 页
类	米 大
颟	草 两 页	艸 两 页	艹 两 页
颢	景 页
颤	亶 页
颥	需 页
显	日 业
颦	频 卑
颅	卢 页
颞	聂 页
颧	雚 页
风	几 乂
飐	风 占
飑	风 包
飒	立 风
飓	风 具
飔	风 思
飕	风 叟
飗	风 留
飘	票 风
飙	猋 风	犬 犬 犬 风
飞	乙 丷
食	人 良
饥	食 几	饣 几
饨	食 屯	饣 屯
饪	食 壬	饣 壬
饫	饣 夭
饬	饣 丿 一 力
饭	食 反	饣 反
饮	食 欠	饣 欠
饴	食 台	饣 台
饲	食 司	饣 司
饱	食 包	饣 包
饰	食 丿 一 巾	饣 丿 一 巾	食 布
饳	饣 出
饺	食 交	饣 交
饸	食 合	饣 合
饼	食 并	饣 并
饷	食 向	饣 向
养	羊 介	羊 乀 丿 丨
饵	食 耳	饣 耳
饹	食 各	饣 各
饻	饣 衣
餐	歹 又 食	歺 又 食
饽	饣 孛
馁	食 妥	饣 妥
饿	食 我	饣 我
馀	饣 余
肴	乂 有	乂 一 丿 肉	乂 一 丿 月
馄	食 昆	饣 昆
馃	饣 果
饯	食 戋	饣 戋
馅	食 臽	饣 臽
馆	食 官	饣 官
餮	殄 食
饧	饣 弓 丿 丿
馉	饣 骨
馇	饣 查
饩	食 气	饣 气
馏	食 留	饣 留
馊	食 叟	饣 叟
馌	饣 盍
馍	食 莫	饣 莫
馒	食 曼	饣 曼
馐	饣 羞
馑	饣 堇
馓	饣 散
馈	食 贵	饣 贵
馔	食 巽	饣 巽
饶	食 尧	饣 尧
饕	號 食
飨	食 乡
餍	厌 食
馋	食 免 冫	饣 免 冫
馕	饣 囊
首	丷 一 丶 目
馗	九 首
馘	首 或
香	禾 日
馥	香 复
馨	声 殳 香	殸 香
驭	马 又
冯	冰 马	冫 马
驮	马 大
驰	马 也
驯	马 川
驳	马 爻
驱	马 区
驻	马 主
驽	奴 马
驹	马 句
驵	马 且
驾	加 马
骀	马 台
驸	马 付
驶	马 史
驼	马 它
驷	马 四
骈	马 并
骇	马 亥
骆	马 各
骎	马 彐 冖 又
骏	马 夋
骋	马 甹	马 由 丂
骍	马 辛
骓	马 隹
骒	马 果
骑	马 奇
骐	马 其
验	马 佥
骛	敄 马
骗	马 扁
骙	马 癸
骞	马 宀 井 大
骘	陟 马
骝	马 留
腾	肉 丷 夫 马	月 丷 夫 马	肉 𠔉 马	月 𠔉 马
驺	马 刍
骚	马 蚤
骟	马 扇
骡	马 累
蓦	莫 马
骜	敖 马
骖	马 参
骠	马 票
骢	马 悤
骅	马 华
骁	马 尧
骣	马 孱
骄	马 乔
惊	心 京	忄 京
驿	马 又 二 丨
骤	马 聚
驴	马 户
骧	马 襄
骥	马 冀
骊	马 丽
骰	骨 殳
骶	骨 氐
骷	骨 古
骸	骨 亥
骺	骨 后
骼	骨 各
髀	骨 卑
髁	骨 果
髂	骨 客
髅	骨 娄
髓	骨 遀
体	人 本	亻 本
髌	骨 宾
髋	骨 宽
高	亠 口 冂 口
髡	髟 兀
髦	髟 毛
髫	髟 召
髭	髟 此
髯	髟 冉
髹	髟 休
髻	髟 吉
鬃	髟 宗
鬈	髟 卷
鬏	髟 秋
鬟	髟 睘
鬓	髟 宾
鬣	髟 巤
阋	门 兒
阄	门 龟
鬯	凵 乂 丶 丶 丶 丶 匕
鬲	一 口 冂 丫 一
鬶	规 鬲
鬻	粥 鬲
鬼	丶 田 儿 厶
魁	鬼 斗
魂	云 鬼
魃	鬼 犮
魄	白 鬼
魅	鬼 未
魆	鬼 戉
魈	鬼 肖
魍	鬼 罔
魉	鬼 两
魏	委 鬼
魑	鬼 离
魔	麻 鬼
魇	厌 鬼
鱼	刀 田 一
鱽	鱼 刀
鱾	鱼 己
鲀	鱼 屯
鲁	鱼 日
鲂	鱼 方
鱿	鱼 尤
鲅	鱼 犮
鲆	鱼 平
鲌	鱼 白
鲉	鱼 由
鲏	鱼 皮
鲇	鱼 占
鲐	鱼 台
鲍	鱼 包
鲋	鱼 付
鲊	鱼 乍
鲞	丷 夫 鱼	𠔉 鱼
鲔	鱼 有
鲛	鱼 交
鲑	鱼 圭
鲜	鱼 羊
鲪	鱼 君
鲧	鱼 系
鲠	鱼 更
鲩	鱼 完
鲤	鱼 里
鲨	沙 鱼
鲬	鱼 甬
鲻	鱼 甾
鲯	鱼 其
鲭	鱼 青
鲷	鱼 周
鲴	鱼 固
鲱	鱼 非
鲵	鱼 兒
鲲	鱼 昆
鲳	鱼 昌
鲸	鱼 京
鲮	鱼 夌
鲰	鱼 取
鲺	鱼 虱
鲹	鱼 参
鳀	鱼 是
鲫	鱼 即
鳊	鱼 扁
鳈	鱼 泉
鳂	鱼 畏
鲽	鱼 枼
鳇	鱼 皇
鳅	鱼 秋
鲾	鱼 畐
鳄	鱼 咢
鳆	鱼 复
鳃	鱼 思
鳁	鱼 昷
鳑	鱼 旁
鲥	鱼 时
鳏	鱼 眔
鳎	鱼 日 羽
鳐	鱼 爪 缶	鱼 爫 缶
鳍	鱼 耆
鲢	鱼 连
鳌	敖 鱼
鳓	鱼 勒
鳘	敏 鱼
鲦	鱼 条
鲣	鱼 坚
鳗	鱼 曼
鳔	鱼 票
鳉	鱼 丬 夕 寸
鳙	鱼 庸
鳕	鱼 雪
鳖	鱼 敝
鳟	鱼 尊
鳝	鱼 善
鳜	鱼 厥
鳞	鱼 粦
鲟	鱼 寻
鲼	鱼 贲
鲎	小 冖 鱼	丶 丶 丶 冖 鱼
鲙	鱼 会
鳡	鱼 感
鳢	鱼 豊
鲚	鱼 齐
鲈	鱼 卢
鲡	鱼 丽
鸟	勹 丶 ㇉ 一
凫	鸟 几
鸠	九 鸟
凤	几 又
鸤	尸 鸟
鸣	口 鸟
鸢	弋 鸟
鸩	冘 鸟
鸨	匕 十 鸟	𠤏 鸟
鸦	牙 鸟
鸥	区 鸟
鸰	令 鸟
鸵	鸟 它
鸳	夗 鸟
鸲	句 鸟
鸮	号 鸟
鸱	氐 鸟
鸪	古 鸟
鸯	央 鸟
鸭	甲 鸟
莺	草 冖 鸟	艸 冖 鸟	艹 冖 鸟
鸸	而 鸟
鸹	舌 鸟
鸻	行 鸟
鸿	水 工 鸟	氵 工 鸟
鸽	合 鸟
鸺	休 鸟
鸼	舟 鸟
鸾	亦 鸟
鹀	巫 乌
鹃	肙 鸟
鹆	谷 鸟
鹁	孛 鸟
鹈	弟 鸟
鹅	我 鸟
鹄	告 鸟
鹉	武 鸟
鹌	奄 鸟
鹏	朋 鸟
鹐	臽 鸟
鹎	卑 鸟
鹊	昔 鸟
鸫	东 鸟
鹑	享 鸟
鹋	苗 鸟
鹕	胡 鸟
鹗	咢 鸟
鹛	眉 鸟
鹜	敄 鸟
鹟	翁 鸟
鹤	隺 鸟
鹠	留 鸟
鹡	脊 鸟
鹘	骨 鸟
鹣	兼 鸟
鹚	兹 鸟
鹞	爪 缶 鸟	爫 缶 鸟
鹝	鬲 鸟
鹧	庶 鸟
鸷	执 鸟
鹨	翏 鸟
鸶	丝 鸟
鹪	焦 鸟
鹩	尞 鸟
鹫	就 鸟
鹇	闲 鸟
鹬	矞 鸟	矛 冏 鸟
鹰	广 人 隹 鸟	广 亻 隹 鸟	广 倠 鸟
鹭	路 鸟
鹱	鸟 蒦
鹲	蒙 鸟
鸬	卢 鸟
鹦	婴 鸟
鹳	雚 鸟
鹂	丽 鸟
鹿	广 乛 一 丨 丨 比
麂	鹿 几
麇	鹿 禾
麈	鹿 主
麋	鹿 米
麒	鹿 其
麓	林 鹿
丽	一 冂 丶 冂 丶
麝	鹿 射
麟	鹿 粦
麦	丰 夕	丰 夂
麸	麦 夫
么	丿 厶
麾	麻 毛
黄	艹 一 田 八
黇	黃 占
黉	小 冖 黄
黍	禾 人 水
黎	黍 勹 丿	禾 勹 丿 人 水
黏	黍 占
黑	口 丷 土 火	口 丷 土 灬	里 丷 火	里 丷 灬
黔	黑 今
默	黑 犬
黛	代 黑
黜	黑 出
黝	黑 幼
点	占 火	占 灬
黟	黑 多
黠	黑 吉
黢	黑 夋
黥	黑 京
黧	禾 勹 丿 黑
党	尚 儿	小 冖 兄
黯	黑 音
黩	黑 卖
黹	业 八 巾 八
黻	黹 犮
黼	黹 甫
黾	口 电
鼋	元 黾
鼍	口 口 田 一 黾	嘼 电
鼎	目 爿 片
鼐	乃 鼎
鼒	才 鼎
鼓	十 豆 支
鼗	兆 鼓
鼙	鼓 卑
鼠	臼 𠄌 丶 丶 𠄌 丶 丶 乀
鼢	鼠 分
鼩	鼠 句
鼫	鼠 石
鼬	鼠 由
鼯	鼠 吾
鼱	鼠 青
鼹	鼠 妟
鼷	鼠 奚
鼻	自 田 廾
鼾	鼻 干
齁	鼻 句
齉	鼻 囊
龀	齿 匕
龁	齿 乞
龅	齿 包
龇	齿 此
龃	齿 且
龆	齿 召
龄	齿 令
龈	齿 艮
龊	齿 足
龉	齿 吾
龋	齿 禹
龌	齿 屋
庞	广 龙
龚	龙 共
龛	合 龙
龟	刀 电
龠	人 一 口 口 口 冊
鲃	鱼 巴
鳚	鱼 尉
鳤	鱼 管
鹮	睘 鸟
